cdr3	peptide	Binding
CASSYVGNTGELFF	SLLMWITQC	1
CASSAGRVSPGELFF	GLCTLVAML	1
CASSSHESQGARSPLHF	TPRVTGGGAM	1
CASSVRTGELFF	HPVGEADYFEY	1
CASSSRTGELFF	KRWIILGLNK	1
CASSLAPGTTNEKLFF	NLVPMVATV	1
CASSLTGGGELFF	TAFTIPSI	1
CASSEGRISPGELFF	GLCTLVAML	1
CASSLGTGSTDTQYF	SSCMGGMNWR	1
CASSLTAPDTEAFF	KRWIILGLNK	1
CASSQSPGGFQYF	GLCTLVAML	1
CASSARQGIDTGELFF	TPRVTGGGAM	1
CASSEGRVLSGELFF	GLCTLVAML	1
CSGGQGEGEQFF	RAKFKQLL	1
CASSLGGGLQETQYF	GTSGSPIIDK	1
CASRTGTSNTGELFF	ATDALMTGY	1
CASQLYSGGDQPQHF	FPRPWLHGL	1
CASSPGTEPNEKLFF	IPSINVHHY	1
CASTSGTGPNEKLFF	IPSINVHHY	1
CASSLRSTGELFF	GILGFVFTL	1
CASSTRQNTEAFF	KRWIILGLNK	1
CASSQGVLAYEQYF	KRWIILGLNK	1
CSARDRGAANTGELFF	RAKFKQLL	1
CASRPTGQLETQYF	ATDALMTGY	1
CASSMRSTGELFF	YVLDHLIVV	1
CASSARSTGELFF	GILGFVFTL	1
CASSPGTLSDTQYF	ELAGIGILTV	1
CASSHQTGELFF	NLVPMVATV	1
CASSLSSATGELFF	AVFDRKSDAK	1
CASSLVAGTYNEQFF	KRWIILGLNK	1
CATSTGDSNQPQHF	EPLPQGQLTAY	1
CASSPGTPRDEQFF	CRVLCCYVL	1
CASSLDSYEQYF	KRWIILGLNK	1
CASTGGSYGYTF	KAFSPEVIPMF	1
CASSIRSSYEQYF	GLCTLVAML	1
CAISESASGSNEQYF	ATDALMTGY	1
CASSTGTSNTGELFF	ATDALMTGY	1
CSARDRTGNTIYF	GLCTLVAML	1
CATTGSYGYTF	KAFSPEVIPMF	1
CASRPGQGSHEQFF	KRWIILGLNK	1
CASSQDRYTGGYTF	RPPIFIRRL	1
CSVGSAGTNEKLFF	GLCTLVAML	1
CSARDRTGNGYTF	GLCTLVAML	1
CSARAGLNNEQFF	KRWIIMGLNK	1
CSVGADGTNEKLFF	GLCTLVAML	1
CSAETGNTEAFF	DATYQRTRALVR	1
CASSLEGSYEQYF	RAKFKQLL	1
CASSLRGVSSYNEQFF	TPRVTGGGAM	1
CASSPSTGTIYGYTF	NLVPMVATV	1
CSVPKVGTSGFNEQFF	QVPLRPMTYK	1
CASSLTGGGYEQYF	LLFNKVTLA	1
CASSYRTGELFF	KRWIILGLNK	1
CASSQRSTGELFF	GLCTLVAML	1
CATSRDAGETQYF	FRCPRRFCF	1
CASSDRQNTEAFF	KRWIILGLNK	1
CASSEGQGYEQFF	NYNYLYRLF	1
CASSLGLNTIYF	TPQDLNTML	1
CASSGQDYGYTF	KAFSPEVIPMF	1
CASSQRSTDTQYF	GILGFVFTL	1
CASSSRSAYEQYF	GILGFVFTL	1
CASSYQTGASYGYTF	NLVPMVATV	1
CASSPDPNTGELFF	YLQPRTFLL	1
CASNGQGARDGYTF	IPSINVHHY	1
CSARDRIGNGYTF	GLCTLVAML	1
CASSSASYGYTF	NLVPMVATV	1
CASSIVGHMNTEAFF	ARMILMTHF	1
CASSIYSNQPQHF	GILGFVFTL	1
CASSSANYGYTF	NLVPMVATV	1
CASSSTGGGGTEAFF	QYDPVAALF	1
CASTGTDYGYTF	KAFSPEVIPMF	1
CATGRGGKIGEQYF	NLVPMVATV	1
CASSPGTLKETQYF	NLVPMVATV	1
CASRPGTSSYEQYF	CPSQEPMSIYVY	1
CASSYATGASYGYTF	NLVPMVATV	1
CASSPGTAPNEKLFF	IPSINVHHY	1
CASSSAFYGYTF	NLVPMVATV	1
CASSSRQNTEAFF	KRWIILGLNK	1
CASRRQGRDNEQFF	RPRGEVRFL	1
CASSYGDLYTGELFF	ELAGIGILTV	1
CASSGGQGNIQYF	GTSGSPIINR	1
CASSPSGQLETQYF	ATDALMTGY	1
CASSSVSEAFF	NLVPMVATV	1
CASSLIGGRNGYTF	NLVPMVATV	1
CASSFRQGSNTGELFF	TPRVTGGGAM	1
CAWSISDLAKNIQYF	NLVPMVATV	1
CASSLASGSNQPQHF	RVRFFFPSL	1
CASSLSGQLDEQYF	ATDALMTGY	1
CASSIRSAHEQFF	GILGFVFTL	1
CSAPDWNNEQFF	CRVLCCYVL	1
CASSTGLYGYTF	GILGFVFTL	1
CASRTGISNTGELFF	ATDALMTGY	1
CASSAASGTDTQYF	FLRGRAYGL	1
CASSLDVGEQYF	KRWIILGLNK	1
CASSMRSADTQYF	GILGFVFTL	1
CASSLYSGADQPQHF	FPRPWLHGL	1
CASSDQGLGTEAFF	EAAGIGILTV	1
CASNAGTGTDTQYF	IPSINVHHY	1
CASSLGGDTYEQYF	GTSGSPIINR	1
CSARGWVSNNQETQYF	KRWIILGLNK	1
CASSHRTGELFF	KRWIILGLNK	1
CSARVGLNNEQFF	KRWIILGLNK	1
CASSSVDEAFF	NLVPMVATV	1
CASSIVAGSYNEQFF	NEGVKAAW	1
CASSQGQYSHEQYF	KRWIILGLNK	1
CASSWGGGSNYGYTF	IVTDFSVIK	1
CASSLFGSPEQPQHF	FPRPWLHGL	1
CASSESQGYEQYF	NYNYLYRLF	1
CASSPHRNTEAFF	RPHERNGFTV	1
CASSIRSTGELFF	GILGFVFTL	1
CSVPKTGTSGFNEQFF	QVPLRPMTYK	1
CASSFEGNTGELFF	NLSALGIFST	1
CASSFQGLGQPQHF	ELAGIGILTV	1
CSARSETGNTIYF	GLCTLVAML	1
CASSLQGMGQPQHF	ELAGIGILTV	1
CASSVGQAYEQYF	FLRGRAYGL	1
CASSQRSTGELFF	YVLDHLIVV	1
CASSFTWTSGGATDTQYF	FLRGRAYGL	1
CASSQGTSDYEQYF	KRWIILGLNK	1
CASRRGPYEQYF	KLVALGINAV	1
CASSFEPGQGFYSNQPQHF	FLKEQGGL	1
CASTDSYGYTF	KAFSPEVIPMF	1
CASSPSRNTEAFF	TPRVTGGGAM	1
CASSFRSGINTGELFF	TPRVTGGGAM	1
CASSLSHSTGNYGYTF	TPRVTGGGAM	1
CASGGSSYEQYF	VAANIVLTV	1
CASSLGVPEAFF	GTSGSPIVNR	1
CASSLGQGSYEQYF	GTSGSPIINR	1
CASSFQTGASYGYTF	NLVPMVATV	1
CASSSVNEAFF	NLVPMVATV	1
CASSLGTASTDTQYF	PTDNYITTY	1
CASSIRAAETQYF	GILGFVFTL	1
CASSLGQGTYEQYF	GTSGSPIVNR	1
CSVGSSGTNEKLFF	GLCTLVAML	1
CATGRGGMIGEQYF	NLVPMVATV	1
CASSARSSYEQYF	GILGFVFTL	1
CASGQKGLDTEAFF	TPRVTGGGAM	1
CASSLVGQLYEQYF	ATDALMTGY	1
CSVGSGGTNEKLFF	GLCTLVAML	1
CASSQDRLTGGYTF	RPPIFIRRL	1
CASSMRSTGELFF	GLCTLVAML	1
CASSLGTGAPYEQYF	CINGVCWTV	1
CASSDSYGYTF	KLVALGINAV	1
CASSPTGQLETQYF	ATDALMTGY	1
CASSETGGTEAFF	EAAGIGILTV	1
CASSFRSTDTQYF	GILGFVFTL	1
CASSLVGDSYNEQFF	ALSKGVHFV	1
CASSMGQGDYEQYF	GTSGSPIVNR	1
CASSSGTVNTGELFF	ATDALMTGY	1
CATSRDGGETQYF	FRCPRRFCF	1
CASSSGQAYEQYF	FLRGRAYGL	1
CASSPISNEQFF	CRVLCCYVL	1
CASSFEPGQGFYSNQPQHF	FLKEKGGL	1
CASSLGQGDFEQYF	GTSGSPIINR	1
CASSTGSYGYTF	NLVPMVATV	1
CASSLSGQLDEQFF	ATDALMTGY	1
CSVGTGGTNEKLFF	GLCTLVAML	1
CASSLKGVSSYNEQFF	TPRVTGGGAM	1
CASSEGGGEQYF	LLLDRLNQL	1
CASSLSPSTGNYGYTF	TPRVTGGGAM	1
CASSLHSRGARTEAFF	TPRVTGGGAM	1
CASSVRASYEQYF	GILGFVFTL	1
CASSFRQGVNTGELFF	TPRVTGGGAM	1
CASRQPGGVNEQFF	EPLPQGQLTAY	1
CASSIGVYGYTF	GILGFVFTL	1
CAWTISDLAKNIQYF	NLVPMVATV	1
CASSVDKGGTDEQFF	IIKDYGKQM	1
CAGSQDRLTGGYTF	RPPIFIRRL	1
CASSFIPGQGTHYSNQPQHF	FLKEKGGL	1
CASRRGPYEQYF	KLVALVINAV	1
CASTPGDEQFF	CRVLCCYVL	1
CASSQRTGELFF	KRWIILGLNK	1
CASSVVGGRYGYTF	NLVPMVATV	1
CSARSGVGNTIYF	GLCTLVAML	1
CASSVEGVADEQYF	AVGSYVYSV	1
CASSLYRGTGELFF	FMPDFDLHL	1
CASSYSRGVGNTIYF	QVPLRPMTYK	1
CASSLGQAYEQYF	EEYLKAWTF	1
CASGLGSYEQYF	GTSGSPIVNR	1
CASASANYGYTF	NLVPMVATV	1
CAIRTGGDEQFF	HSKKKCDEL	1
CASSVDKGGTDTQYF	IIKDYGKQM	1
CASSQGIFAYEQYF	KRWIIMGLNK	1
CASSQKGLDTEAFF	TPRVTGGGAM	1
CASSFGGGLQETQYF	CISSCNPNL	1
CASSSHDKQGARSPLHF	TPRVTGGGAM	1
CASSLGQLEQYF	NEGVKAAW	1
CASSPSGTPYEQYF	GPGHKARVL	1
CASSIVTGPYNEQFF	NEGVKAAW	1
CASSLTNEQFF	NLVPMVATV	1
CASSLGGGNQETQYF	GTSGSPIIDK	1
CSARVGVGNTIYF	GLCTLVAML	1
CSAESGNTEAFF	DATYQRTRALVR	1
CASSFGGGSNYGYTF	IVTDFSVIK	1
CASSGTTSFDEQFF	KAFSPEVIPMF	1
CSARDRGLGNTIYF	GLCTLVAML	1
CSARAGVGNTIYF	GLCTLVAML	1
CASSLGTSAYEQYF	KRWIILGLNK	1
CSSQEGGYGYTF	GLCTLVAML	1
CASSIGSYGYTF	GILGFVFTL	1
CASSPRQGGTGELFF	HSKKKCDEL	1
CASSLIASGGYNEQFF	RAKFKQLL	1
CASSSAYYGYTF	NLVPMVATV	1
CASSPTTGTGHYGYTF	NLVPMVATV	1
CASGSGLANNEQFF	KRWIILGLNK	1
CATGTGDSNQPQHF	EPLPQGQLTAY	1
CASSMLGGGRDEQFF	VSFIEFVGW	1
CSARDKTGNGYTF	GLCTLVAML	1
CASSLFTDNRDGYTF	IPSINVHHY	1
CASSSRASYEQYF	GILGFVFTL	1
CASSVRSSYEQYF	GILGFVFTL	1
CSARDRGGENTGELFF	NLVPMVATV	1
CASSLGGGNQETQYF	GTSGSPIINR	1
CASSLIRGTGELFF	RAKFKQLL	1
CASSARSGELFF	HPVGEADYFEY	1
CASSFQGFTEAFF	NLVPMVATV	1
CASSDRQNSPLHF	KRWIILGLNK	1
CASSLGVNTIYF	TPQDLNTML	1
CASSIVNEQFF	NLVPMVATV	1
CASSIYSGQPQHF	GILGFVFTL	1
CASSWGGGSHYGYTF	IVTDFSVIK	1
CASSFEAGQGFFSNQPQHF	FLKEQGGL	1
CASSLSTGAPYEQYF	CINGVCWTV	1
CASSLRQGANTGELFF	TPRVTGGGAM	1
CASSDLNTGELFF	YLQPRTFLL	1
CASSLRGESSYNEQFF	TPRVTGGGAM	1
CASSELAGVGETQYF	RAKFKQLL	1
CASSGGSGNIQYF	GTSGSPIIDK	1
CASSPLAGVGETQYF	RAKFKQLL	1
CAISESSIGNQPQHF	ATDALMTGY	1
CASSLGQAYEQYF	FLRGRAYGL	1
CASSVRSAYEQYF	GILGFVFTL	1
CASSYWDRTTSGNTIYF	NLVPMVATV	1
CASTTGQKNTEAFF	CRVLCCYVL	1
CASSLDVNEQFF	KRWIILGLNK	1
CASSIRSAYEQYF	GILGFVFTL	1
CASSNRQGGTGELFF	HSKKKCDEL	1
CASRPGQGSHEQYF	KRWIILGLNK	1
CASSPSGQLDEQFF	ATDALMTGY	1
CASSKRSTDTQYF	GILGFVFTL	1
CASSGGSYGYTF	KAFSPEVIPMF	1
CASSLGTSGSYEQYF	GPGHKARVL	1
CASSLDRNEQFF	KRWIILGLNK	1
CSARGEAITEKLFF	GLCTLVAML	1
CASSTRSSYEQYF	YVLDHLIVV	1
CASSARSADTQYF	GILGFVFTL	1
CASSLQGLGQPQHF	EAAGIGILTV	1
CASSFTLGTGGVEQYF	NLVPMVATV	1
CASSEASGGFYNEQFF	IVTDFSVIK	1
CASRPGQGSHEQFF	KRWIIMGLNK	1
CSARTGVGNTIYF	GLCTLVAML	1
CASSYSRGAGNTIYF	QVPLRPMTYK	1
CASSSLNTEAFF	RAKFKQLL	1
CASSSVNEQFF	NLVPMVATV	1
CASSPSHGPNEKLFF	IPSINVHHY	1
CASSQEGGGGGQPQHF	TPQDLNTML	1
CASSPDIEQYF	YLQPRTFLL	1
CASSLTAPDTDAFF	KAFSPEVIPMF	1
CASSIRSSYEQYF	GILEFVFTL	1
CASSPRGREETQYF	FPQGEAREL	1
CASSQSTGELFF	KRWIILGLNK	1
CASSMTGLGQPQHF	ELAGIGILTV	1
CATSPGDEQYF	CRVLCCYVL	1
CASSVFGELFF	NEGVKAAW	1
CASSIRAGETQYF	GILGFVFTL	1
CASSIRSTGELFF	GLCTLVAML	1
CASSQSPGGYQFF	GLCTLVAML	1
CASSTRSAYEQYF	GILGFVFTL	1
CSAKDRGAENTGELFF	RAKFKQLL	1
CASTSGDEQFF	CRVLCCYVL	1
CASSFLPGQGSYYSNQPQHF	FLKEKGGL	1
CASSMGGEQYF	KLVALGINAV	1
CASSPGQLGNTIYF	KRWIILGLNK	1
CASSSTGGGGAEAFF	QYDPVAALF	1
CASTTGDEQFF	CRVLCCYVL	1
CSVGSEGTNEKLFF	GLCTLVAML	1
CASSPQGLGTEAFF	ELAGIGILTV	1
CASSQSPGGQQFF	GLCTLVAML	1
CASSVRTGELFF	KRWIILGLNK	1
CASSTGIYGYTF	GILGFVFTL	1
CASSMRSSYEQYF	GILGFVFTL	1
CASSLGQAYEQYF	EEYLQAFTY	1
CASSGGSGNIQYF	GTSGSPIINR	1
CASTPGDEQYF	CRVLCCYVL	1
CASSLGPVEAFF	HPKVSSEVHI	1
CASSIFGEQFF	NEGVKAAW	1
CASRPSGQLDEQFF	ATDALMTGY	1
CASATGTYGYTF	GILGFVFTL	1
CASSGTDYGYTF	KAFSPEVIPMF	1
CASSLYGGGDQPQHF	FPRPWLHGL	1
CASSPSRNTEAFF	RPHERNGFTVL	1
CASSSRQGGTGELFF	HSKKKCDEL	1
CASSQEGGGDGQPQHF	TPQDLNTML	1
CASSIVQGPYNEQFF	NEGVKAAW	1
CASSFDAEAFF	SLYNTVATL	1
CASSLIGQGLGDEQFF	TPRVTGGGAM	1
CASSMIGHSNQPQHF	SLYNTVATL	1
CASSLGAGNYGYTF	TPRVTGGGAM	1
CASSLSGGNQETQYF	CINGVCWTV	1
CSARSRVGNTIYF	GLCTLVAML	1
CASSLGDLYTGELFF	FLKEKGGL	1
CASSFRTVNSYEQYF	TPRVTGGGAM	1
CASSTGQVSPGELFF	GLCTLVAML	1
CASSIRSGYEQFF	GILGFVFTL	1
CASGDRQNSPLHF	KRWIILGLNK	1
CASSMGQGDYEQYF	GTSGSPIINR	1
CASSGTASFDEQFF	KAFSPEVIPMF	1
CASSLTSEQFF	NLVPMVATV	1
CASSASTGEAYGYTF	GPGHKARVL	1
CASSPSRNTEAFF	RPHERNGFTV	1
CASSLFTDRRDGYTF	IPSINVHHY	1
CASSLVGPPGELFF	LPPIVAKEI	1
CASSIVSGPYNEQFF	NEGVKAAW	1
CASSPGRLSHEQFF	KRWIILGLNK	1
CSAGQGEGEQYF	RAKFKQLL	1
CASSLMQGTDTQYF	KAFSPEVIPMF	1
CASSIRSTGELFF	YVLDHLIVV	1
CASSPYRNTEAFF	RPHERNGFTVL	1
CASSQETGSYEQYF	RPPIFIRRL	1
CASSIRASNEQFF	GILGFVFTL	1
CASSPGTGPNEKLFF	IPSINVHHY	1
CASGGNSYEQYF	LLLDRLNQL	1
CAIRAGGDEQFF	HSKKKCDEL	1
CASSIRSAYEQYF	YVLDHLIVV	1
CASSQEGGGQGQPQHF	TPQDLNTML	1
CASSRADLSYEQYF	KRWIILGLNK	1
CASSQQGLGTEAFF	ELAGIGILTV	1
CASSRSTGELFF	KRWIILGLNK	1
CSARDRVGNTIYF	GLCTLVAML	1
CASSLMGPGQPQHF	NLVPMVATV	1
CASSKQTGTGNYGYTF	GILGFVFTL	1
CASSPARNTEAFF	RPHERNGFTV	1
CASSIRSSHEQYF	GILGFVFTL	1
CASSLGTSSYEQYF	KRWIIMGLNK	1
CSVGAAGTNEKLFF	GLCTLVAML	1
CASSVEGVADTQYF	AVGSYVYSV	1
CASSLYGGPEQPQHF	FPRPWLHGL	1
CASSPGDEQFF	CRVLCCYVL	1
CASSLGSYEQYF	GTSGSPIVNR	1
CASSLTGPGDQPQHF	RAKFKQLL	1
CSVGAGGTNEKLFF	GLCTLVAML	1
CASSPVSNEQFF	CRVLCCYVL	1
CASSQETGSYEQFF	RAKFKQLL	1
CASSSRSSYEQYF	GILGLVFTL	1
CSVGQGGTNEKLFF	GLCTLVAML	1
CASSFEAGQGFFSNQPQHF	FLKEMGGL	1
CAISESSSGSNEQFF	ATDALMTGY	1
CASSLAGDSYNEQFF	ALSKGVHFV	1
CASSFEPGQGFYSNQPQHF	FLKETGGL	1
CASSFRTVSSYEQYF	TPRVTGGGAM	1
CATSPDPNTGELFF	YLQPRTFLL	1
CASSLEGGGYEQYF	NEGVKAAW	1
CASSLGQGAYEQYF	GTSGSPIVNR	1
CASGSGLAGNEQFF	NLVPMVATV	1
CASSYQTGAAYGYTF	NLVPMVATV	1
CASSQETGSYEQFF	RPPIFIRRL	1
CSARDEVGNTIYF	GLCTLVAML	1
CASSLSGSYEQYF	SPRWYFYYL	1
CASSEGRVLPGELFF	GLCTLVAML	1
CASSYLPGQGDHYSNQPQHF	FLKEMGGL	1
CASSIRSGYEQYF	GILGFVFTL	1
CSTQEGGYGYTF	GLCTLVAML	1
CSARDGTGNGYTF	GLCTLVAML	1
CSARIGVGNTIYF	GLCTLVAML	1
CASSIGIYGYTF	GILGFVFTL	1
CASSARTGELFF	HPVGEADYFEY	1
CSARDRVGNGHTF	GLCTLVAML	1
CSARDRVGNGYTF	GLCTLVAML	1
CASSLGIYGYTF	GILGFVFTL	1
CASSLGAPEAFF	GTSGSPIVNR	1
CASRETYEQYF	ATDALMTGY	1
CASSEAGGTEAFF	GLNKIVRMY	1
CASSTGDSNQPQHF	EPLPQGQLTAY	1
CASSGRSADTQYF	GILGFVFTL	1
CATSREGGETQYF	FRCPRRFCF	1
CASSPISNEQYF	CRVLCCYVL	1
CASSPVTGTGHYGYTF	NLVPMVATV	1
CASSQGSYEQYF	KLVALGINAV	1
CASSWGSYEQFF	GTSGSPIVNR	1
CASSYLPGQGDHYSNQPQHF	FLKETGGL	1
CASSLGQGDFEQYF	GTSGSPIVNR	1
CASSFSGNTGELFF	RAKFKQLL	1
CASSLRSSYEQYF	GILGFVFTL	1
CAISDSSSGSNEQFF	ATDALMTGY	1
CASSLTSATGELFF	AVFDRKSDAK	1
CASTGSYGYTF	KAFSPEVIPMF	1
CASSLAGESSYNEQFF	VVMSWAPPV	1
CSATNRDRGLEQYF	HPKVSSEVHI	1
CASSLGQIEQYF	NEGVKAAW	1
CASSPGTVKETQYF	EMLFSHGLVK	1
CASSIYSGPYNEQFF	GILGFVFTL	1
CASSVRAGETQYF	GILGFVFTL	1
CASSGTYGYTF	KAFSPEVIPMF	1
CASSQSPGGIQYF	GLCTLVAML	1
CASSLSGDDYNEQFF	ALSKGVHFV	1
CASSVRASDEQYF	GILGFVFTL	1
CASSVDKGGADEQFF	IIKDYGKQM	1
CASSSGTAPNEKLFF	IPSINVHHY	1
CASSITLGTGGVEQYF	NLVPMVATV	1
CASSYQTGTGNYGYTF	NLVPMVATV	1
CASSYQTGTGTYGYTF	FLKEKGGL	1
CASRDTYEQYF	ATDALMTGY	1
CASSYWDRITSGNTIYF	NLVPMVATV	1
CASSIHSTDTQYF	GILGFVFTL	1
CASSEGQVSPGELFF	GLCTLVAML	1
CASSFGVNTEAFF	MLNIPSINV	1
CAISESTVGNQPQHF	ATDALMTGY	1
CASSTRSSYEQYF	GILGFVFTL	1
CASTGQGYGYTF	KAFSPEVIPMF	1
CASSLGANTIYF	TPQDLNTML	1
CASTPGTGPNEKLFF	IPSINVHHY	1
CANSLGTSSYEQYF	KRWIILGLNK	1
CASSYLPGQGDHYSNQPQHF	FLKEQGGL	1
CASSIRSSYEQYF	GILGFVFTL	1
CASSSRSSYEQYF	GILGFVFTL	1
CASSTGQKNTEAFF	CRVLCCYVL	1
CASSLAPGATNEKLFF	NLVPMVATV	1
CASSGRSTDTQYF	GILGFVFTL	1
CASSFEPGQGFYSNQPQHF	FLKEMGGL	1
CASSPPTAPNEKLFF	IPSINVHHY	1
CASSSAHYGYTF	MLAKALRKV	1
CASSLGGAEAFF	LLYDANYFL	1
CASSRGTSDYEQYF	KRWIIMGLNK	1
CASSMGSYGYTF	GILGFVFTL	1
CASRPGTASYEQYF	CPSQEPMSIYVY	1
CASSLTSAAGELFF	AVFDRKSDAK	1
CASSTGNYGYTF	GILGFVFTL	1
CASSYQTGTGVYGYTF	NLVPMVATV	1
CASSLYGSPDQPQHF	FPRPWLHGL	1
CASSPTRNTEAFF	TPRVTGGGAM	1
CASSVRSTGELFF	GILGFVFTL	1
CASSPNRNTEAFF	RPHERNGFTVL	1
CATSFDSEAFF	SLYNTVATL	1
CASSPGQFGNTIYF	KRWIILGLNK	1
CASSAGQGVTYEQYF	SFHSLHLLF	1
CASSMRSTGELFF	GILGFVFTL	1
CASADMNTGELFF	YLQPRTFLL	1
CASRPGQGGYEQYF	ISPRTLNAW	1
CASSFQGYTEAFF	NLVPMVATV	1
CASSSHERQGQNSPLHF	TPRVTGGGAM	1
CASSEGRVSPGELFF	GLCTLVAML	1
CASSVQGLGQPQHF	ELAGIGILTV	1
CASSQSRGSGNTIYF	HSKKKCDEL	1
CASSYVGQLDEQFF	ATDALMTGY	1
CASSRGDTEAFF	KLVALGINAV	1
CASRAGTSNTGELFF	ATDALMTGY	1
CASSSGQKNTEAFF	CRVLCCYVL	1
CASSAGQGWKEQYF	ISPRTLNAW	1
CASSLGAPEAFF	GTSGSPIINR	1
CASSIVSSSYNEQFF	VAANIVLTV	1
CASSRGTSDYEQYF	KRWIILGLNK	1
CASSRRGATTSTDTQYF	HSKKKCDEL	1
CSARDSTGNGYTF	GLCTLVAML	1
CASSLGQGYEQYF	GTSGSPIINR	1
CASSLGVNTEAFF	DATYQRTRALVR	1
CASSQSPGGEQYF	GLCTLVAML	1
CASSLGQGTYEQYF	GTSGSPIINR	1
CASRMQGRDNEQFF	RPRGEVRFL	1
CASSGRSTGELFF	GILGFVFTL	1
CASSSGGGEQYF	MLNIPSINV	1
CASAAGTYGYTF	GILGFVFTL	1
CASSSGQGNIQYF	CINGVCWTV	1
CASSLVGQLDEQYF	ATDALMTGY	1
CASSLRQGINTGELFF	TPRVTGGGAM	1
CASSGTSYGYTF	KAFSPEVIPMF	1
CASSLGGQTYEQYF	GTSGSPIINR	1
CASSLGSGNYGYTF	IVTDFSVIK	1
CSARLRKLSGNTIYF	GLCTLVAML	1
CASSIAGGGEDTQYF	KRWIILGLNK	1
CASTPGQKNTEAFF	CRVLCCYVL	1
CASTLTGLGQPQHF	ELAGIGILTV	1
CAISESSSGNQPQHF	ATDALMTGY	1
CASSPRGRDETQYF	FPQGEAREL	1
CSARLGVGNTIYF	GLCTLVAML	1
CASSLTGGGKLFF	TAFTIPSI	1
CSATSRDRGLEQYF	HPKVSSEVHI	1
CSVGTQGTNEKLFF	GLCTLVAML	1
CASSGGQGNIQYF	GTSGSPIIDK	1
CASSFDSYEQYF	KRWIILGLNK	1
CASSLMASGGYNEQFF	RAKFKQLL	1
CASSLLGPGQPQHF	ELAGIGILTV	1
CASSSGTINTGELFF	ATDALMTGY	1
CASSIVGHLNTEAFF	ARMILMTHF	1
CASSLSGQLDTQYF	ATDALMTGY	1
CASSPGDEQYF	CRVLCCYVL	1
CASSIRASYEQYF	GILGFVFTL	1
CASSPARNTEAFF	TPRVTGGGAM	1
CASSSGTGPNEKLFF	IPSINVHHY	1
CASSSAHYGYTF	NLVPMVATV	1
CASSPLTGTGHYGYTF	NLVPMVATV	1
CASSLVGPPGEAFF	LPPIVAKEI	1
CSAEQGNTEAFF	DATYQRTRALVR	1
CASSPSGTPYERYF	GPGHKARVL	1
CASSQRSTGELFF	GILGFVFTL	1
CASSVSTGEAYGYTF	GPGHKARVL	1
CASSLGGTEAFF	LLYDANYFL	1
CASSVDKGGVDEQFF	IIKDYGKQM	1
CASSLMSGTDTQYF	KAFSPEVIPMF	1
CASSFTWTSGGTTDTQYF	NLVPMVATV	1
CASNPGTGTDTQYF	IPSINVHHY	1
CASRPPGGVNEQFF	EPLPQGQLTAY	1
CASRQGPYEQYF	TPQDLNTML	1
CASSARSGELFF	HPVGQADYFEY	1
CASSLLQGSDTQYF	ELAGIGILTV	1
CASSGSYGYTF	KAFSPEVIPMF	1
CASSSLGGAGTGELFF	NLVPMVATV	1
CASSQGTPRDEQYF	CRVLCCYVL	1
CASSVAGGDEQFF	GLCTLVAML	1
CASSYSRGSGNTIYF	QVPLRPMTYK	1
CASSVRSGELFF	HPVGEADYFEY	1
CASSEGQGYEQYF	NYNYLYRLF	1
CASSRRGAATSTDTQYF	HSKKKCDEL	1
CASSLDRGEQFF	KRWIILGLNK	1
CAIGTGDSNQPQHF	EPLPQGQLTAY	1
CASSSATYGYTF	NLVPMVATV	1
CASSLGQGSYEQYF	GTSGSPIVNR	1
CSVGSGGTNERLFF	GLCTLVAML	1
CASSYGSYEQYF	KLVALGINAV	1
CASSMADLSYEQYF	KRWIILGLNK	1
CASSVASGTDTQYF	FLRGRAYGL	1
CASSYPRGGEGSPLHF	RAKFKQLL	1
CASSLGTSSSYEQYF	KRWIIMGLNK	1
CASSLFSGGDQPQHF	FPRPWLHGL	1
CASSVVNEQFF	NLVPMVATV	1
CASSPGRNTEAFF	RPHERNGFTVL	1
CASSIFGELFF	NEGVKAAW	1
CSARLRELSGNTIYF	GLCTLVAML	1
CASSPTRNTEAFF	RPHERNGFTVL	1
CASSLTGAGDQPQHF	RAKFKQLL	1
CASSVRTGELFF	QVPLRPMTYK	1
CASSLGSAEAFF	GTSGSPIVNR	1
CASSAPAGELFF	HPVGEADYFEY	1
CASSLGGSTEAFF	LLYDANYFL	1
CASSIRSGETQYF	GILGFVFTL	1
CASSHSRGSGNTIYF	HSKKKCDEL	1
CASSKRSTGELFF	GILGFVFTL	1
CASSSHDRQGQNSPLHF	TPRVTGGGAM	1
CASSSSGQLDEQFF	ATDALMTGY	1
CASSVAGGDEQYF	GLCTLVAML	1
CASSLGNTEAFF	GLCTLVAML	1
CASSFEAGQGFFSNQPQHF	FLKEKGGL	1
CASSPITGTGAYGYTF	NLVPMVATV	1
CASSIRSSNEQFF	GILGFVFTL	1
CASSFTGLGQPQHF	ELAGIGILTV	1
CASSLRTVSSYEQYF	TPRVTGGGAM	1
CASSAGTINTGELFF	ATDALMTGY	1
CASSLRQGIDTGELFF	TPRVTGGGAM	1
CSAPDWGNEQFF	CRVLCCYVL	1
CSARDRGAENTGELFF	RAKFKQLL	1
CASSPSSGPNEKLFF	IPSINVHHY	1
CASSSLDTEAFF	RAKFKQLL	1
CASSLGTSSYEQYF	KRWIILGLNK	1
CASSLAGDDYNEQFF	ALSKGVHFV	1
CSARDQTGNGYTF	GLCTLVAML	1
CASSPDIDQFF	YLQPRTFLL	1
CASSPGRTSHEQFF	KRWIILGLNK	1
CASSLIGHSNQPQHF	SLYNTVATL	1
CASNYPRGGEGSPLHF	RAKFKQLL	1
CASSQEKGTEAFF	CINGVCWTV	1
CASSTGFYGYTF	GILGFVFTL	1
CSARGWVSNNRETQYF	KAFSPEVIPMF	1
CSARGQAITEKLFF	GLCTLVAML	1
CASSGRNYGYTF	KAFSPEVIPMF	1
CASSPGQGGYEQYF	KAFSPEVIPMF	1
CASSGQNYGYTF	KAFSPEVIPMF	1
CASSLAGSTEAFF	LLYDANYFL	1
CASSLGGGLQETQYF	GTSGSPIINR	1
CASSIVAGGYNEQFF	NLVPMVATV	1
CASSIGQAYEQYF	FLRGRAYGL	1
CASNAGQGWKEQYF	ISPRTLNAW	1
CASSFDSEAFF	SLYNTVATL	1
CASSLRGTGELFF	FLKEKGGL	1
CASSPLTGTGVYGYTF	NLVPMVATV	1
CASSMRSTDTQYF	GILGFVFTL	1
CASSLGNYEQYF	VLEETSVML	1
CAISESSSGNNEQFF	ATDALMTGF	1
CASSLHTQGARTEAFF	TPRVTGGGAM	1
CASSEAAGGFYNEQFF	IVTDFSVIK	1
CASSSVNEQYF	NLVPMVATV	1
CASSLGQGAYEQYF	GTSGSPIINR	1
CASSVAGGGQETQYF	VVVGAVGVGK	1
CASSTRSGYEQYF	GILGFVFTL	1
CASSIFGEQYF	NEGVKAAW	1
CASSARSGELFF	HPVGDADYFEY	1
CASSPQTGAIYGYTF	NLVPMVATV	1
CASSLLGQLYEQYF	ATDALMTGY	1
CAISESSAGNQPQHF	ATDALMTGY	1
CASSPTTAPNEKLFF	IPSINVHHY	1
CASSVVASSYNEQFF	GILGFVFTL	1
CASSPHRNTEAFF	RPHERNGFTVL	1
CASSPQRNTEAFF	RPHERNGFTVL	1
CASSLEGSYEQYF	KLVALGINAV	1
CSGGQGEGEQYF	RAKFKQLL	1
CASSLGPTEAFF	TPQDLNTML	1
CASSTGQAYEQYF	FLRGRAYGL	1
CASSDMNTGELFF	YLQPRTFLL	1
CASSPITGTGIYGYTF	NLVPMVATV	1
CASSSRSGELFF	HPVGEADYFEY	1
CASSPGQYSHEQYF	KRWIILGLNK	1
CSARSEVGNTIYF	GLCTLVAML	1
CASSSGIYGYTF	NLVPMVATV	1
CASSFEAGQGFFSNQPQHF	FLKETGGL	1
CASSYLGNTGELFF	SLLMWITQC	1
CASSTRSTGELFF	GILGFVFTL	1
CAISTGDSNQPQHF	EPLPQGQLTAY	1
CASSVFGEQYF	NEGVKAAW	1
CASSQESGTEAFF	CINGVCWTV	1
CASSVGQGVTYEQYF	VTEHDTLLY	1
CASSLLGGAGTGELFF	NLVPMVATV	1
CASSSRAAYEQYF	GILGFVFTL	1
CASSGQGYGYTF	KAFSPEVIPMF	1
CASQPGQKNTEAFF	CRVLCCYVL	1
CASSPGTLADTQYF	ELAGIGILTV	1
CASSAPTGELFF	HPVGEADYFEY	1
CASSSGSYEQYF	GTSGSPIVNR	1
CASRSGTSNTGELFF	ATDALMTGY	1
CASSRRGESSYNEQFF	TPRVTGGGAM	1
CASSHRQGGTGELFF	HSKKKCDEL	1
CASSLRNSYEQFF	GLCTLVAML	1
CASSLGGDTYEQYF	GTSGSPIVNR	1
CASSQGIFAYEQYF	KRWIILGLNK	1
CASGTGDSNQPQHF	EPLPQGQLTAY	1
CASSLYSGPDQPQHF	FPRPWLHGL	1
CASSVGGEQFF	GTSGSPIINR	1
CASTGGGYGYTF	KAFSPEVIPMF	1
CASSMLDGGRDEQFF	EIYKRWII	1
CASSYVGNTGELFF	SLLMWITQV	1
CASSPARNTEAFF	RPHERNGFTVL	1
CASSLRSTGELFF	GLCTLVAML	1
CASKGQGARDGYTF	IPSINVHHY	1
CASSYLPGQGDHYSNQPQHF	FLKEKGGL	1
CASSLVGGRHGYTF	NLVPMVATV	1
CASSVDKGGADTQYF	IIKDYGKQM	1
CSARDRSLGNTIYF	GLCTLVAML	1
CASSIRSTDTQYF	GILGFVFTL	1
CASSPQTGTIYGYTF	NLVPMVATV	1
CASSEGDTEAFF	KLVALGINAV	1
CASSSIGQGLGDEQFF	TPRVTGGGAM	1
CSARDATGNGYTF	GLCTLVAML	1
CASSTRSTGELFF	NLVPMVATV	1
CASSLGGQTYEQYF	GTSGSPIVNR	1
CASSTRATGELFF	GILGFVFTL	1
CASSLAGGSNQPQHF	GILGFVFTL	1
