cdr3	peptide	Binding
CASSLGGNYEQYF	LPRRSGAAGA	1
CASSIGTYGYTF	GILGFVFTL	1
CARDSTGNGYTF	GLCTLVAML	1
CANSIKGYNEQF	FPRPWLHGL	1
CASSQDAGGGYEQYF	LPRRSGAAGA	1
CASSSDIFNYGYTF	CRVLCCYVL	1
CASSAGGTEAFF	KMVAVFYTT	1
CASSLRTSGGDEQYF	RFYKTLRAEQASQ	1
CASSLTGTYSYNEQFF	CRVLCCYVL	1
CSAGQGEGEQYF	RAKFKQLL	1
CASSRRSTGELFF	GILGFVFTL	1
CASSVQGFTEAF	NLVPMVATV	1
CASSSRSGETQYF	GILGFVFTL	1
CASSQDRTSGNTIYF	HPKVSSEVHI	1
CASSYGGGYEQYF	LLWNGPMAV	1
CASSQSPGGMQYF	GLCTLVAML	1
CATGRGGKIGEQYF	NLVPMVATV	1
CASSLAGTQETQYF	KAFSPEVIPMF	1
CSGGQGEGEQYF	RAKFKQLL	1
CASSLIGVSSYNEQFF	LPRRSGAAGA	1
CASSVAQLAGGTDTQYF	GLCTLVAML	1
CASSLGTTYEQYF	LPRRSGAAGA	1
CASSWSGGGARDTQYF	VTEHDTLLY	1
CASSIFSNQPQHF	GILGFVFTL	1
CASSSRQGKEAF	LPPIVAKEI	1
CSARTGVGNTIYF	GLCTLVAML	1
CASSQRTSGSDEQYF	RFYKTLRAEQASQ	1
CSARDRGLGNTIYF	GLCTLVAML	1
CATSRVAGETQYF	FRCPRRFCF	1
CASSELASGVNEQFF	RFYKTLRAEQASQ	1
CASNRRTSGTYEQYF	RFYKTLRAEQASQ	1
CASSLFGSNEKLFF	LPRRSGAAGA	1
CASSFRDRGHYEQYF	TPRVTGGGAM	1
CASSLGAGNYGYTF	TPRVTGGGAM	1
CASSSRATGELFF	GILGFVFTL	1
CASSKRASGGTDTQYF	RFYKTLRAEQASQ	1
CASSLLGQLYEQYF	ATDALMTGY	1
CAISEETPNTEAFF	CRVLCCYVL	1
CASGIGGNGYPF	GILGFVFTL	1
CASSLYGVGDTQYF	LPRRSGAAGA	1
CASSMTVMNTEAFF	FIDQYYSSI	1
CASSLGLSEQFF	LPRRSGAAGA	1
CASSVGQGVTYEQYF	VTEHDTLLY	1
CASSPGQFGNTIYF	KRWIILGLNK	1
CSARDGLTGHYEQYF	NLVPMVATV	1
CASSIRSAYEQFF	GILGFVFTL	1
CASSPARNTEAFF	RPHERNGFTVL	1
CSARLAGDTGELFF	NLVPMVATV	1
CASSSGQPNTEAFF	CRVLCCYVL	1
CSARDATGNGYTF	GLCTLVAML	1
CASSTRAAYEQYF	GILGFVFTL	1
CASSLRSDRAQETQYF	RPHERNGFTVL	1
CASSQDEYEQYF	LPRRSGAAGA	1
CSARIGVGNTIYF	GLCTLVAML	1
CAWTLAGRETGELFF	GLCTLVAML	1
CASSVQSTDTQYF	RLVPYLEFL	1
CASSQSPGGQQFF	GLCTLVAML	1
CASSLHDRGVRTEAFF	TPRVTGGGAM	1
CASSLGQAGETQYF	FWIDLFETIG	1
CASSLFGDNEKLFF	VTEHDTLLY	1
CASSSPGQGFHEQYF	LPRRSGAAGA	1
CASSGRATDTQYF	GILGFVFTL	1
CSARDRDSSDTQYF	LPRRSGAAGA	1
CASRLRTSGGTDTQYF	RFYKTLRAEQASQ	1
CASSSTGYEQYF	GLCTLVAML	1
CSVEDFYNEQLF	GLCTLVAML	1
CASSLFSGASQTQYF	FPRPWLHGL	1
CASSLVGWETQYF	PQPQLPYPQPQ	1
CASSLMGRGPNNGELFF	GLCTLVAML	1
CSARDGTGNGYTF	GLCTLVAML	1
CASSALASGDKQYF	RFYKTLRAEQASQ	1
CASSPWGQTASSYNEQFF	GILGFVFTL	1
CASSDRAGNEQFF	GILGFVFTL	1
CASSIHGANQPQHF	GILGFVFTL	1
CASSQAGSNYGYTF	LPRRSGAAGA	1
CASSSVSGGAFNEQFF	GILGFVFTL	1
CATSPGQGPYEQYF	FRCPRRFCF	1
CASSQDGLGGSYNEQFF	VTEHDTLLY	1
CASSFRSTDTQYF	GILGFVFTL	1
CASSYGGLGQPQHF	EAAGIGILTV	1
CASSLGTDYEQYF	LPRRSGAAGA	1
CASSRRTSGTYEQYF	RFYKTLRAEQASQ	1
CASSLVGQLYEQYF	ATDALMTGY	1
CASSGTTSFDEQF	KAFSPEVIPMF	1
CASRTGAANIYEQHF	TPRVTGGGAM	1
CASSQRSTDTQYF	GILGFVFTL	1
CSARDGLAGHYEQYF	NLVPMVATV	1
CASSLGVGQPQHF	ELAGIGILTV	1
CASSLSGDEQYF	LLWNGPMAV	1
CASSLRTSGSYEQYF	RFYKTLRAEQASQ	1
CASSLRGRASTDTQYF	LPRRSGAAGA	1
CSVGGTFYGYTF	GLCTLVAML	1
CASSSGAAYEQYF	LLWNGPMAV	1
CASSPLSGNEQYF	LPRRSGAAGA	1
CASSLSGQEIDTQHF	GLCTLVAML	1
CAGSLWSGIADTQYF	FPRPWLHGL	1
CASSANQGYEQYF	NLNCCSVPV	1
CASSIRAQETQYF	GILGFVFTL	1
CASSAGTINTGELF	ATDALMTGY	1
CASSQQGLGQPQHF	EAAGIGILTV	1
CASSQGLAGHSYEQYF	LPRRSGAAGA	1
CASSQGLANTDTQYF	LPRRSGAAGA	1
CATTGTYGYTF	KAFSPEVIPMF	1
CASSQSPGGTQSF	GLCTLVAML	1
CASSYNQGYEQYF	ILNAMIAKI	1
CASSPGQGSTDTQYF	LPRRSGAAGA	1
CASSTEGLLSTDTQYF	VTEHDTLLY	1
CSASETGVGQPQHF	EAAGIGILTV	1
CANSPTSSTTSYEQYF	GLCTLVAML	1
CASSLYSGGGQPQHF	FPRPWLHGL	1
CASSWTGGGARDTQYF	VTEHDTLLY	1
CASSLGVYEQYF	FLCMKALLL	1
CATSSGTGAYEQYF	LLWNGPMAV	1
CASSTGTGNTEAFF	FLCMKALLL	1
CASSQGTGNTEAFF	VTEHDTLLY	1
CASRPRRAGGDRGLFF	GLCTLVAML	1
CASSSSSEGSQETQYF	RPHERNGFTVL	1
CASSAGQGVTYEQYF	SFHSLHLLF	1
CASSLAQGYEQYF	VTEHDTLLY	1
CASTLQGLGQPQHF	EAAGIGILTV	1
CASSIRSTGELFF	GILGFVFTL	1
CASSYSEGYEQYF	GLCTLVAML	1
CTSSHRASGGDTQYF	RFYKTLRAEQASQ	1
CASSQRASGGDEQFF	RFYKTLRAEQASQ	1
CASSAGSYGYTF	GILGFVFTL	1
CASSQAPGGEQYF	GLCTLVAML	1
CASSLTGTEAF	IPSINVHHY	1
CASRTSGTYEQYF	RFYKTLRAEQASQ	1
CSVGSGGTNEKLF	GLCTLVAML	1
CASSIRTTDTQYF	PQPELPYPQPQ	1
CSARSRVGNTIYF	GLCTLVAML	1
CSAPDWGNEQFF	CRVLCCYVL	1
CASSVEGALTDTQYF	YLDELIRNT	1
CASSLEGSTDTQYF	VTEHDTLLY	1
CASSLRTSGGSDTQYF	RFYKTLRAEQASQ	1
CASSIISADTQYF	GILGFVFTL	1
CASSARTSGGLDEQFF	RFYKTLRAEQASQ	1
CASSYDRSYEQYF	RYPLTFGWCF	1
CSVEGFRTEKNQPQHF	GLCTLVAML	1
CASTPSGTPSYEQYF	EAAGIGILTV	1
CASSGLASGTDTQYF	RFYKTLRAEQASQ	1
CASSLVGSYEQYF	LPRRSGAAGA	1
CASSDRSGNEQFF	GILGFVFTL	1
CASSPRQGKEAF	LPPIVAKEI	1
CASSDSQNEQFF	GLCTLVAML	1
CASSQIDSNQPQHF	CRVLCCYVL	1
CASSQDRLDTQYF	LPRRSGAAGA	1
CASSDLAVSYNEQFF	LPRRSGAAGA	1
CASSPGLANTDTQYF	LPRRSGAAGA	1
CSARDRAGEGYNEQFF	GILGFVFTL	1
CASRSLVSTGELFF	RFYKTLRAEQASQ	1
CASSQLIPGLLYGYAF	GLCTLVAML	1
CASSPHRNTEAFF	TPRVTGGGAM	1
CASSLEAGDQPQHF	VTEHDTLLY	1
CASSSRTSGGTDTQYF	RFYKTLRAEQASQ	1
CASSIRSVYEQYF	GILGFVFTL	1
CASSLSQGAYEQYF	LPRRSGAAGA	1
CASSQGRGDTEAFF	VTEHDTLLY	1
CASSFRDRGRYEQYF	TPRVTGGGAM	1
CASSLTTPPSTDTQYF	EAAGIGILTV	1
CASSQGRGDTEAFF	LPRRSGAAGA	1
CASSIRWTDTQYF	PQPELPYPQPQ	1
CASSPHTEAFF	FIDCYLLAI	1
CASSFRAGYNEQFF	LPRRSGAAGA	1
CASSQDRGKDTQYF	FLTVFSHFM	1
CASSWTGNTEAFF	VVLSWAPPV	1
CASASANYGYTF	NLVPMVATV	1
CASSLGQGTYEQYF	LLFALHFSA	1
CSARGQAITEKLFF	GLCTLVAML	1
CGSSVVGDSRETQYF	EIYKRWII	1
CASSLDPSQPQHF	LPRRSGAAGA	1
CSARSGVGNTIYF	MLNIPSINV	1
CSVPGTVQETQYF	GLCTLVAML	1
CASSYYSGGTTYNEQF	TPGPGVRYPL	1
CASSAGTIYNEQFF	RLGPYLEFL	1
CASSPGTAYEQYF	LLWNGPMAV	1
CASSQGLAGPSYEQYF	LPRRSGAAGA	1
CASSPGDEQYF	CRVLCCYVL	1
CASSSVDRNSYEQYF	FPRPWLHGL	1
CASSPGTGSYEQYF	RAKFKQLL	1
CASSQEGGGDGQPPHF	TPQDLNTML	1
CASSTRATGELFF	GILGFVFTL	1
CASSLSDPYEQYF	LPRRSGAAGA	1
CASSYSSSSYNEQFF	CTELKLSDY	1
CASSIGLNQPQHF	KIVALGINAV	1
CASSEWGGSNQPQHF	LPRRSGAAGA	1
CASSPGTVAYEQYF	LLWNGPMAV	1
CAWSRAAVEQFF	GLCTLVAML	1
CASSFRQGSNTGELFF	TPRVTGGGAM	1
CASSPRTSGGGEQYF	RFYKTLRAEQASQ	1
CASSSPGQGYYEQYF	VLFHRAFLV	1
CASSLYSGGDQPQHF	FPRPWLHGL	1
CASSGRTSGGSDTQYF	RFYKTLRAEQASQ	1
CASSPGQLGNTIYF	KRWIILGLNK	1
CASSPPGGSYNEQFF	LPRRSGAAGA	1
CASSPGTSGVGKQFF	RFYKTLRAEQASQ	1
CASSPYPGANVLTF	FLCMKALLL	1
CASSLFSGGDQPQHF	FPRPWLHGL	1
CASSHRDSGNTIYF	NLVPMVATV	1
CASSLGGTEAFF	LPRRSGAAGA	1
CASSVRHTDTQYF	PQPELPYPQPE	1
CASSGGSYGYTF	KAFSPEVIPMF	1
CASSLSGQETDTQYF	GLCTLVAML	1
CASSPQRNTEAFF	RPHERNGFTVL	1
CASSPSGGAYGYTF	LLWNGPMAV	1
CASSFGSHGYTF	LPRRSGAAGA	1
CASSLGQGNTEAFF	LPRRSGAAGA	1
CASSGGRGSPLHF	SFHSLHLLF	1
CASSPDRVQEQFF	SFHSLHLLF	1
CASSYGGGGYEQFF	LPRRSGAAGA	1
CSARAGVGNTIYF	GLCTLVAML	1
CASSPAGVSYEQYF	LLWNGPMAV	1
CASSYGLNTEAFF	GILGFVFTL	1
CASSTRSADTQYF	GILGFVFTL	1
CASSQRTSGRSYEQYF	LPRRSGAAGA	1
CASSARTGELF	KRWIILGLNK	1
CASSLRAAGDHEQYF	PQPQLPYPQPQ	1
CASSSGQHNSPLHF	CRVLCCYVL	1
CASSLFGDNEKLFF	LPRRSGAAGA	1
CASSFGGNEAFF	NLVPMVATV	1
CASSTEGLLSTDTQYF	LPRRSGAAGA	1
CASSYSASGGEQFF	GLCTLVAML	1
CASSYSAGGPYEQYF	LPRRSGAAGA	1
CASSVRFTDTQYF	PQPELPYPQPQ	1
CASSAPGLLEQYF	LPRRSGAAGA	1
CASSLRRGVDTGELFF	TPRVTGGGAM	1
CASSSTGGGGTEAF	QYDPVAALF	1
CSVEAGTYEQFF	LPRRSGAAGA	1
CASSLGDSSYEQYF	RPHERNGFTVL	1
CASSIRAGETQYF	GILGFVFTL	1
CASSLHYTGENTEAFF	GILGFVFTL	1
CASSGGQKNEKLFF	CRVLCCYVL	1
CASSLSLAGREQFF	VTEHDTLLY	1
CASSLAESVYEQYF	GILGFVFTL	1
CASSDLAGGTDTQYF	LLWNGPMAV	1
CAWSGQGYEQFF	GILGFVFTL	1
CASSPTSGGYEQYF	KLNTITPVV	1
CASSQSPGGEQYF	TPRVTGGGAM	1
CASSIRSAYEQYF	GILGFVFTL	1
CASSFGVYEQYF	GILGFVFTL	1
CASSLDRPGDEQYF	CRVLCCYVL	1
CASSSGTVSYEQYF	LLWNGPMAV	1
CASSLEGFTEAFF	NLVPMVATV	1
CSARSEVGDTIYF	GLCTLVAML	1
CASSSTGAGTDTQYF	GLCTLVAML	1
CASSPLVWGRFSNQPQHF	GLCTLVAML	1
CASSIYSGGYNEQFF	GILGFVFTL	1
CASSVRSADTQYF	GILGFVFTL	1
CASSGRSTDTQYF	GILGFVFTL	1
CSVGTGGTNEQF	GLCTLVAML	1
CATSPGDEQYF	CRVLCCYVL	1
CASSLVAWETQYF	PQPELPYPQPQ	1
CASSLGGSTDTQYF	LPRRSGAAGA	1
CASSQDGLGGSYNEQFF	LPRRSGAAGA	1
CSARTSGTYEQYF	GLCTLVAML	1
CASSYSGLGQPQHF	ELAGIGILTV	1
CASSLVGPPGEAF	LPPIVAKEI	1
CASSFMTDTQYF	LLFGYPVYV	1
CASSSSQADEQFF	LPRRSGAAGA	1
CASSIISTDTQYF	GILGFVFTL	1
CASSLWAGETQYF	NLNCCSVPV	1
CASSLEGFTEAF	NLVPMVATV	1
CASSQVDLRYEQFF	CRVLCCYVL	1
CASSTGLYGYPF	GILGFVFTL	1
CASSEKASGGDTQYF	RFYKTLRAEQASQ	1
CASSLYSGAEQPQHF	FPRPWLHGL	1
CASSLLAGPYNEQFF	GILGFVFTL	1
CASRTGTSNTGELF	ATDALMTGY	1
CASSQVKGYEQYF	LPRRSGAAGA	1
CASRSGTSNTGELF	ATDALMTGY	1
CASSLNPRQGRDEQFF	VTEHDTLLY	1
CASSGQGYGYAF	KAFSPEVIPMF	1
CSAPDTGLGQPQHF	ELAGIGILTV	1
CASSSRTSGINEQFF	NLVPMVATV	1
CASSSGTSGETQYF	LPRRSGAAGA	1
CASSSRSAIEQFF	GILGFVFTL	1
CASSMRSSWEQYF	GILGFVFTL	1
CASSLAGGGYEQYF	LPRRSGAAGA	1
CASSYYSNQPQHF	GILGFVFTL	1
CSASPGLANTDTQYF	FRCPRRFCF	1
CASSSTGFEQYF	LPRRSGAAGA	1
CASSLAGGDGYTF	LPRRSGAAGA	1
CASSQGAFGYTF	GILGFVFTL	1
CASSPGLAGAREQFF	TPRVTGGGAM	1
CASSQGPGLLSYGQYF	GILGFVFTL	1
CASSQDFRGGYAQYF	GLCTLVAML	1
CASSGRSGIEQYF	GILGFVFTL	1
CAWSGQGYEQYF	GILGFVFTL	1
CASSTRAGETQYF	GILGFVFTL	1
CASSIRSTETQYF	GILGFVFTL	1
CASSPGQLGNTIYF	KRWIIMGLNK	1
CASSQATPNTEAFF	CRVLCCYVL	1
CASRAPGLAFQGTQYF	RFYKTLRAEQASQ	1
CASSLYTGSDQPQHF	FPRPWLHGL	1
CASSSQSNQPQHF	GILGFVFTL	1
CASSGGGAEAFF	ILTGLNYEA	1
CSARGQAITEKLLF	GLCTLVAML	1
CASSLAAGGGETQYF	RLWEPLRVV	1
CASSQAGVGQPQHF	EAAGIGILTV	1
CASSLAYSGANVLTF	IMNDMPIYM	1
CASSPTRNTEAFF	TPRVTGGGAM	1
CASSLGGTEAFF	KMVAVFYTT	1
CASSLGAGAYEQFF	GILGFVFTL	1
CASSLGGASYEQYF	LLWNGPMAV	1
CASSLGYEQYF	LPRRSGAAGA	1
CASSAQGNSNQPQHF	LPRRSGAAGA	1
CASSSGRASGANVLTF	GLCTLVAML	1
CASSPGQGGTDTQYF	GLCTLVAML	1
CASSVDKGGADEQF	IIKDYGKQM	1
CASSAKTSGGSDTQYF	RFYKTLRAEQASQ	1
CASSQTGVGQPQHF	EAAGIGILTV	1
CASSSRSAGELFF	GILGFVFTL	1
CASSPTRNTEAFF	RPHERNGFTVL	1
CASSTRSTGELFF	GILGFVFTL	1
CASSELASGLAEQFF	RFYKTLRAEQASQ	1
CASSLSRGAYEQYF	QIKVRVKMV	1
CASSDRRIYGYTF	RFYKTLRAEQASQ	1
CASSEETGEGGHEQYF	GLCTLVAML	1
CASSYPDTQYF	CRVLCCYVL	1
CASSLGGSPGELFF	TPRVTGGGAM	1
CATSQGSYGYTF	GILGFVFTL	1
CASSQGGGTEAFF	LLWNGPMAV	1
CASSYGQGYEQYF	NLNCCSVPV	1
CASSIRATDTQYF	PQPQLPYPQPQ	1
CASSARTSGNQPQHF	RFYKTLRAEQASQ	1
CASSLGSTPYEQYF	TPRVTGGGAM	1
CSARGQAITEKLSF	GLCTLVAML	1
CASSYGNTGELFF	MLGEQLFPL	1
CASSIRSDYEQYF	GILGFVFTL	1
CASSDLASGTGEQFF	RFYKTLRAEQASQ	1
CSVGAGGTNEKLF	GLCTLVAML	1
CASSDLASGTNEQFF	RFYKTLRAEQASQ	1
CASSGRATGELFF	GILGFVFTL	1
CASSIRSGYEQFF	GILGFVFTL	1
CASSIRSSYEQFF	GILGFVFTL	1
CASSYGQNYEQYF	GILGFVFTL	1
CASSEFARGNQPQHF	RFYKTLRAEQASQ	1
CANSQSPGGTQYF	GLCTLVAML	1
CASSIGTFETQYF	GLCTLVAML	1
CSAGTGGTNEKLFF	GLCTLVAML	1
CASSLTDTQYF	LPRRSGAAGA	1
CASSLDPDQPQHF	TPRVTGGGAM	1
CGARDGPGNGYTF	GLCTLVAML	1
CSAKGQAITEKLFF	GLCTLVAML	1
CASSYHSSYEQYF	FMLYLLTLM	1
CASHEGAGGYGELFF	RFYKTLRAEQASQ	1
CASSIRSSYNEQF	GILGFVFTL	1
CASSQLIPGLLYGYTF	GLCTLVAML	1
CSVEAGGRIYNEQF	GLCTLVAML	1
CASSLGISYEQYF	NLNCCSVPV	1
CASSIRPSYERYF	GILGFVFTL	1
CSATHRDRGLEQYF	HPKVSSEVHI	1
CASSLEGYTEAF	NLVPMVATV	1
CASSFTLGTGGVEQYF	NLVPMVATV	1
CASSQVKVGAVDGYTF	EAAGIGILTV	1
CASSLRTGGVDTQYF	LPRRSGAAGA	1
CASSPTSSTTSYEQYF	GLCTLVAML	1
CASSQGLAGANEQFF	GLCTLVAML	1
CASSLSVGAGGTNEKLF	GLCTLVAML	1
CASSPSSGAYEQYF	NLVPMVATV	1
CASSYSNGYEQYF	ILNAMIAKI	1
CASRLGQGRRDEQFF	GILGFVFTL	1
CASSPSSGGYEQYF	LPRRSGAAGA	1
CASSKQTGTIGGYTF	NLVPMVATV	1
CASSLRTSGGVDTQYF	RFYKTLRAEQASQ	1
CASGRLASGTDTQYF	RFYKTLRAEQASQ	1
CASSLRAGGVDTQYF	PQPELPYPQPQ	1
CASSPDRAQTQYF	SFHSLHLLF	1
CASSTRSGYEQYF	GILGFVFTL	1
CASSQSTSGSYEQYF	GILGFVFTL	1
CASSTRSGETQYF	GILGFVFTL	1
CASSIGLWGYTF	GILGFVFTL	1
CASSEYATSNEQFF	RFYKTLRAEQASQ	1
CASSGTASFDEQF	KAFSPEVIPMF	1
CASSLGASPGELFF	TPRVTGGGAM	1
CASSGRSADTQYF	GILGFVFTL	1
CASSVRSSYEQYF	GILGFVFTL	1
CASSPRGGGETQYF	TPGPGVRYPL	1
CASSSGTSGVGEQFF	RFYKTLRAEQASQ	1
CASSVAGGYEQYF	KLWASPLHV	1
CASSIRSDTQYF	GILGFVFTL	1
CASSLSGGGEAFF	RPHERNGFTVL	1
CASSTGTSGETQYF	LPRRSGAAGA	1
CASSPGTGGTDTQYF	LPRRSGAAGA	1
CASSLFSGPSQTQYF	FPRPWLHGL	1
CAWSVQGLGYGYTF	EAAGIGILTV	1
CASSGMASGTDTQYF	RFYKTLRAEQASQ	1
CASSQAGAYEQYF	LLWNGPMAV	1
CASSQRSQETQYF	GILGFVFTL	1
CASSYSSSYNEQFF	GILGFVFTL	1
CSARGQAITEKLCF	GLCTLVAML	1
CASSIRSADTQYF	GILGFVFTL	1
CASSQGTSGVGEQFF	RFYKTLRAEQASQ	1
CASSLVVPQLPTYEQYF	LPRRSGAAGA	1
CASSRRSTDTQYF	GILGFVFTL	1
CASSPHRNTEAFF	RPHERNGFTVL	1
CASSLGGYEQYF	GLCTLVAML	1
CASSLRTETYNEQFF	CRVLCCYVL	1
CASRQGARGGNQPQHF	RFYKTLRAEQASQ	1
CASSTGTSNTGELF	ATDALMTGY	1
CASRIGAAGNSPLHF	LPRRSGAAGA	1
CAISESTPNTEAFF	CRVLCCYVL	1
CASSILGSYNEQFF	IMNDMPIYM	1
CASGGGGAEAFF	NLVPMVATV	1
CASSLYGGGDQPQHF	FPRPWLHGL	1
CASSPVSGSSYEQYF	GLCTLVAML	1
CANSFQGFTEAF	NLVPMVATV	1
CASSSRSGHEQYF	GILGFVFTL	1
CASSQGPGLLSYEQYF	GILGFVFTL	1
CASSSAGTEAFF	VLLGVKLSGV	1
CASSARSAETQYF	GILGFVFTL	1
CASSFRGNTGELFF	FLSDHLYLV	1
CASSPGTSYEQYF	ALYGSVPVL	1
CASSSHDLTGMNTEAFF	TPRVTGGGAM	1
CASSQDRGAVYGYTF	SFHSLHLLF	1
CSVEGNSYEQYF	FLCMKALLL	1
CASSLFGSPEQPQHF	FPRPWLHGL	1
CSSSLRGSNQPQHF	YVLDHLIVV	1
CASSLYGSPDQPQHF	FPRPWLHGL	1
CASSQRTSGGADTQYF	RFYKTLRAEQASQ	1
CASSLTGLNEQFF	LPRRSGAAGA	1
CASGLVPGGLVYEQYF	GILGFVFTL	1
CASSHRASGGDTQYF	RFYKTLRAEQASQ	1
CSVGTGGTNEKLFF	TPRVTGGGAM	1
CASSVVNEAFF	NLVPMVATV	1
CASSESRMGSQANYGYTF	KAFSPEVIPMF	1
CASSLQGLGTEAF	ELAGIGILTV	1
CASSLYGVGETQYF	LPRRSGAAGA	1
CASGLGPLTGLGPEAF	HPKVSSEVHI	1
CASSPRTSGADTQYF	RFYKTLRAEQASQ	1
CASSQDRGGEQYF	LPRRSGAAGA	1
CASSVRSSYEQYF	NLVPMVATV	1
CASSIFSGQPQHF	GILGFVFTL	1
CSARDQTGNGYTF	GLCTLVAML	1
CASSLQGLGTEAF	EAAGIGILTV	1
CAWSRGAVEQYF	GLCTLVAML	1
CASSLGVGSDTQYF	LPRRSGAAGA	1
CASSPAGGAYNEQFF	LPRRSGAAGA	1
CASSISGDYGYTF	GLCTLVAML	1
CASSLRAAGGHEQYF	PQPQLPYPQPQ	1
CASSQAQGLSNSPLHF	KRWIILGLNK	1
CSATRRDRGLEQYF	HPKVSSEVHI	1
CAWSVQGLGYGYTF	ELAGIGILTV	1
CASSLYSNQPQHF	GILGFVFTL	1
CASSSDSYEQYF	LPRRSGAAGA	1
CASSWTGGSYNEQFF	LPRRSGAAGA	1
CASSLNRGPADTQYF	GILGFVFTL	1
CASSDGASGVGEQYF	RFYKTLRAEQASQ	1
CASSLRSSYEQYF	GILGFVFTL	1
CASNQSPGGTQYF	GLCTLVAML	1
CASSLAGADGYTF	LPRRSGAAGA	1
CASSLSLAGREQFF	LPRRSGAAGA	1
CASSPRGSGETQYF	LPRRSGAAGA	1
CASSFRQGSDTGELFF	CTELKLSDY	1
CSVLGGGGYEQYF	LPRRSGAAGA	1
CASSERRIYGYTF	RFYKTLRAEQASQ	1
CASSQVNSNQPQHF	CRVLCCYVL	1
CAGRASTGSGNTIYF	TPQDLNTML	1
CASSIRNTDTQYF	PQPELPYPQPQ	1
CSYAAGVNEQYF	GLCTLVAML	1
CSARGQAITAKLFF	GLCTLVAML	1
CASSLVGNEQFF	LPRRSGAAGA	1
CASSLRYTDTQYF	PQPELPYPQPE	1
CASSQGTISYEQYF	LLWNGPMAV	1
CASSQVEGYEQYF	NLNCCSVPV	1
CASSFRAGYNEQYF	LPRRSGAAGA	1
CASSWTGGSYNEQYF	LPRRSGAAGA	1
CASSYQTGTIYGYTF	NLVPMVATV	1
CAISECAIRGTSGLTDTQYF	TQGYFPDWQNY	1
CAAGTGDSNQPQHF	RPHERNGFTVL	1
CASSDRATGGDTQYF	RFYKTLRAEQASQ	1
CASSFSGSTDTQYF	GLCTLVAML	1
CASSLKLAGTDTQYF	LLWNGPMAV	1
CASSSRSGIEQFF	GILGFVFTL	1
CSATDRASGIEQYF	HPKVSSEVHI	1
CASSTRSSYEQYF	LLWNGPMAV	1
CASSSRQSKEAF	LPPIVAKEI	1
CASSIRSDNEQFF	GILGFVFTL	1
CASSLAGADNEQFF	ILTGLNYEV	1
CASSWSGGGASATQYF	VTEHDTLLY	1
CSARGQDITEKLFF	GLCTLVAML	1
CASSQSPGSTQYF	GLCTLVAML	1
CASSQDRWDVMSKNIQYF	VLFGLGFAI	1
CASSQVTGYEQYF	NLNCCSVPV	1
CASSSAHPNTEAFF	CRVLCCYVL	1
CASSLRFTDTQYF	PQPELPYPQPE	1
CASSPTGGSSYEQYF	VTEHDTLLY	1
CASSIRSGWEQYF	GILGFVFTL	1
CASSIRTDTQYF	PQPELPYPQPQ	1
CASSLYTGGDQPQHF	FPRPWLHGL	1
CVSSIRSAYEQYF	GILGFVFTL	1
CASSLGQKNTEAFF	CRVLCCYVL	1
CASSVRSTGGLF	GILGFVFTL	1
CASSTSLGGGGRQSF	GILGFVFTL	1
CSVPGLLNTEAF	EAAGIGILTV	1
CASSEGASGLGEQYF	RFYKTLRAEQASQ	1
CSVIQGYGNQPQHF	LPRRSGAAGA	1
CASSRRTSGGLDTQYF	RFYKTLRAEQASQ	1
CASRLYSGGDKEQYF	FPRPWLHGL	1
CASSELASGTDTQYF	RFYKTLRAEQASQ	1
CASSPDRSPEAFF	SFHSLHLLF	1
CASSSGQGYEQYF	LPRRSGAAGA	1
CASSQAQREWDEQYF	LPRRSGAAGA	1
CASSLGGSGYEQYF	VTEHDTLLY	1
CASSTRSTDTQYF	GILGFVFTL	1
CASSGRASGELFF	GILGFVFTL	1
CASSYGGGTYEQYF	LPRRSGAAGA	1
CASSIGGYGYTF	FLYNPLTRV	1
CSVLGGGGYEQYF	VTEHDTLLY	1
CSVEGRSYEQYF	LPRRSGAAGA	1
CASSSGRDSAANVLTF	GLCTLVAML	1
CASSVVGDSRETQYF	KAFSPEVIPMF	1
CASSMGSYGYTF	GILGFVFTL	1
CASSLVQGYEQYF	GLCTLVAML	1
CASSSTITGMGDSGNTIYF	TPQDLNTML	1
CASSQEGGGGGQPQHF	TPQDLNTML	1
CASSQGTGNTEAFF	LPRRSGAAGA	1
CASSSRSTGELFF	GILGFVFTL	1
CASSSQGAYGYTF	LLWNGPMAV	1
CASSRLAGSTDTQYF	QIKVRVKMV	1
CASSLTGGDTEAFF	LPRRSGAAGA	1
CASSIRSTDTQYF	PQPELPYPQPE	1
CASSLGLGQPQHF	ELAGIGILTV	1
CASSELTSGGDEQFF	RFYKTLRAEQASQ	1
CASSLASATGELF	AVFDRKSDAK	1
CAWSRGAVEQLF	GLCTLVAML	1
CASSLGGSYEQYF	LPRRSGAAGA	1
CASSQSPSGTQYF	GLCTLVAML	1
CSVATSGGSNEQFF	LLWNGPMAV	1
CASTHAGRPYEQFF	LPRRSGAAGA	1
CASSLSGQLDTQYF	ATDALMTGY	1
CASTPGQKNTEAFF	CRVLCCYVL	1
CASSLGQGDNEQFF	LPRRSGAAGA	1
CASSLSWGYEQYF	GILGFVFTL	1
CASSIRAGYEQYF	GILGFVFTL	1
CASSAGQGYEQYF	KLWASPLHV	1
CASSYDRGYEQYF	RYPLTFGWCF	1
CASGQSPGGTQYF	GLCTLVAML	1
CASSLSVGAAGTNEKLF	GLCTLVAML	1
CASSLWGGDFSQEQF	FPRPWLHGL	1
CASSELASGTGEQFF	RFYKTLRAEQASQ	1
CASSIRSNQPQHF	GILGFVFTL	1
CSVDRRADEQFF	LLWNGPMAV	1
CASSWSGGGARATQYF	VTEHDTLLY	1
CASSLMGRGPNTGELLF	GLCTLVAML	1
CASRTGGEETQYF	IIKDYGKQM	1
CASSMRSQETQYF	GILGFVFTL	1
CASSVSQGGYEQYF	NLNCCSVPV	1
CASRPRRAGGDRKLFF	GLCTLVAML	1
CASSIQSTDTQYF	GILGFVFTL	1
CASSVAGGQVTDTQYF	TPGPGVRYPL	1
CASSMGQGTYEQYF	GILGFVFTL	1
CASSQGGVGQPQHF	EAAGIGILTV	1
CASSQAGSNYGYTF	VTEHDTLLY	1
CSARDQKGNGYTF	GLCTLVAML	1
CASSWSGGGARDTQHF	VTEHDTLLY	1
CASSLSLLAGNNEQF	NLVPMVATV	1
CASSPGQGPYEQYF	LLWNGPMAV	1
CASSQALPYAQYF	NLVPMVATV	1
CASSQGGLGQPQHF	EAAGIGILTV	1
CASSFMGSSSYEQYF	EAAGIGILTV	1
CASSPQRNTEAFF	TPRVTGGGAM	1
CASSPDRVPEAFF	SFHSLHLLF	1
CASSLVGTEAFF	CRVLCCYVL	1
CASSLGGSTDTQYF	PQPELPYPQPE	1
CASSYGDTQYF	LPRRSGAAGA	1
CASSYSATGGEQYF	ELAGIGILTV	1
CSAPTSGGPNEQFF	LLWNGPMAV	1
CASSSRQGGTGELF	HSKKKCDEL	1
CASSVGGGYEQYF	KLWASPLHV	1
CASSQGLASYEQYF	LPRRSGAAGA	1
CASSLMGRGPSTGELFF	GLCTLVAML	1
CASSLSGGTDTQYF	LPRRSGAAGA	1
CASSIGQGGYEQYF	LPRRSGAAGA	1
CASSYRDSYEQYF	GLCTLVAML	1
CASSELGGAGTGELF	NLVPMVATV	1
CASSLVNTEAFF	LPRRSGAAGA	1
CASSHSPGGTQYF	GLCTLVAML	1
CASSLYSGADQPQHF	FPRPWLHGL	1
CASSFGVNTGELFF	LPRRSGAAGA	1
CASSDRDRGHYEQYF	TPRVTGGGAM	1
CASSQGEGYEQYF	KLWASPLHV	1
CASSFASGGYNEQFF	YLLFMIGYT	1
CASSFRTSDTQYF	PQPELPYPQPQ	1
CASSIRSSYERYF	GILGFVFTL	1
CASSSGAGEANEQFF	GLCTLVAML	1
CASSEGQVSPGELF	GLCTLVAML	1
CASSLGWGAEQYF	LPRRSGAAGA	1
CASSQAGLAAYNEQFF	GLCTLVAML	1
CASSILSNQPQHF	GILGFVFTL	1
CASVNDGATYEQYF	NLVPMVATV	1
CASSLGSAPGELFF	TPRVTGGGAM	1
CASSFGQNYEQYF	KLWASPLHV	1
CASSLRRGPDTGELFF	LPRRSGAAGA	1
CASSPGTGYEQYF	KLWASPLHV	1
CASSRLTSGGADTQYF	RFYKTLRAEQASQ	1
CASSQDQGGEQYF	LPRRSGAAGA	1
CASSLSQGAETQYF	FWIDLFETIG	1
CSVPTSGGSNEQFF	LLWNGPMAV	1
CASSMGQGGETQYF	FWIDLFETIG	1
CAWSVSDLAKNIQYF	NLVPMVATV	1
CASSLTSAAGELF	AVFDRKSDAK	1
CASSLMGREPNTGELFF	GLCTLVAML	1
CSARDRSLGNTIYF	GLCTLVAML	1
CASSEFVRGNQPQHF	RFYKTLRAEQASQ	1
CASSVGSGTEAFF	GILGFVFTL	1
CASSPGLAGANEQFF	GLCTLVAML	1
CSASLAGDTGELFF	LPRRSGAAGA	1
CASSIGGNGYPF	GILGFVFTL	1
CASSLASTDTQYF	LPRRSGAAGA	1
CASSIRSTDTQYF	GILGFVFTL	1
CAGSEGRDQETQYF	FPRPWLHGL	1
CASSLGVGADTQYF	LPRRSGAAGA	1
CASSLRASGGSDTQYF	RFYKTLRAEQASQ	1
CATSRDGGETQYF	FRCPRRFCF	1
CASSLPGGPYEQYF	LPRRSGAAGA	1
CASSPLALYFNEQF	GILGFVFTL	1
CASSLAGYEQYF	NLVPMVATV	1
CASSAGTAYNEQFF	FRCPRRFCF	1
CASSDSYEQYF	ELAGIGILTV	1
CASSEGQGYEQYF	VLENFTIFLV	1
CASSEYGGSNQPQHF	LPRRSGAAGA	1
CASSLGIYGYTF	GILGFVFTL	1
CASSIRSGVEQYF	GILGFVFTL	1
CASSPTGGNTGELFF	VTEHDTLLY	1
CASSWGGAYEQYF	LLWNGPMAV	1
CASSIGHYGYTF	GILGFVFTL	1
CASSIRSSDTQYF	GILGFVFTL	1
CASSQVDLSYEQYF	CRVLCCYVL	1
CASSLGAYEQYF	GLCTLVAML	1
CSVTSERTGTTWGYTF	RAKFKQLL	1
CASSQSPGGVQYF	GLCTLVAML	1
CASSLAGSNYEQYF	LPRRSGAAGA	1
CASSETGGTEAF	EAAGIGILTV	1
CANSYATGIGNYGYTF	NLVPMVATV	1
CASSQGALGYTF	KLFEFLVHGV	1
CASSTKEGGTGELFF	GILGFVFTL	1
CASSRGGGTEAFF	KLVALGINAV	1
CASSWSGGAARDTQYF	VTEHDTLLY	1
CASSLAGAGNEQFF	VTEHDTLLY	1
CSVGTVGTNEKELF	GLCTLVAML	1
CASSVRSGDTQYF	GILGFVFTL	1
CASSQGLGSYEQYF	LPRRSGAAGA	1
CASSLAWTSGRYEQYF	LPRRSGAAGA	1
CASSSTAYEQYF	LPRRSGAAGA	1
CASSQGGTEAFF	LPRRSGAAGA	1
CASSQGGSDTQYF	LPRRSGAAGA	1
CASSQFTSGSYNEQFF	LPRRSGAAGA	1
CASSYPNQPQHF	LLWNGPMAV	1
CSATSRDRGLEQYF	HPKVSSEVHI	1
CASSYGGSSYEQYF	SLLWMNLFV	1
CASSLRTSGGVDTQDF	RFYKTLRAEQASQ	1
CASSGQGAYEQYF	LLWNGPMAV	1
CASSEAASGVGEQYF	RFYKTLRAEQASQ	1
CASSGQGAYGYTF	LLWNGPMAV	1
CAWSRVGGYEQYF	GILGFVFTL	1
CASSRLAGGFDEQFF	RFYKTLRAEQASQ	1
CASTLTGLGQPQHF	EAAGIGILTV	1
CSVGGSFYGYTF	GLCTLVAML	1
CASSSKTGELF	KRWIILGLNK	1
CASTIQGLGQPQHF	EAAGIGILTV	1
CATGRGGMIGEQYF	NLVPMVATV	1
CASSPRTSGGSDTQYF	RFYKTLRAEQASQ	1
CASSLLPNTGELFF	FRCPRRFCF	1
CASSVGGVPYNEQFF	LLWNGPMAV	1
CASSSRSAYEQYF	GILGFVFTL	1
CSVSGERGTDTQYF	LLWNGPMAV	1
CASSLGGNTGELFF	ELAGIGILTV	1
CASSELTSGVSEQYF	RFYKTLRAEQASQ	1
CASSSRASYEQYF	GILGFVFTL	1
CASSPISNEQYF	CRVLCCYVL	1
CASSLHDRGSRTEAFF	TPRVTGGGAM	1
CASSQDFQGGYEQYF	GLCTLVAML	1
CASSLRSTGELF	GILGFVFTL	1
CARDSVGNGYTF	GLCTLVAML	1
CASSIRHTDTQYF	PQPQLPYPQPQ	1
CASHEGAGGFGELFF	RFYKTLRAEQASQ	1
CASSPRARGNQPQHF	RFYKTLRAEQASQ	1
CASSVTSATGELF	AVFDRKSDAK	1
CASKPTRANEQFF	RFYKTLRAEQASQ	1
CASSLGGPFNEQFF	GLCTLVAML	1
CASSIHGAETQYF	GILGFVFTL	1
CASSDRASGGDTQYF	RFYKTLRAEQASQ	1
CASTLGQGNTEAFF	YLLAIFSGL	1
CASSLAGAGNEQFF	LPRRSGAAGA	1
CASSQGQLGNTIYF	KRWIIMGLNK	1
CASSQDSSGGLGEQFF	GLCTLVAML	1
CASSFQGFTEAF	NLVPMVATV	1
CASSVRSAYEQYF	GILGFVFTL	1
CASSLSGGNEAFF	FLCMKALLL	1
CASSIRSSTEAFF	GILGFVFTL	1
CARSWAGGPRDEQYF	NLVPMVATV	1
CASTHAGRPYEQYF	VTEHDTLLY	1
CASSVGSTEAFF	ILTGLNYEV	1
CASRPDRGNTQYF	SFHSLHLLF	1
CASSLGAGSYEQYF	VLFHRAFLV	1
CASSLNRGPSDTQYF	GILGFVFTL	1
CASSQTGAGQPQHF	LPRRSGAAGA	1
CSVGTGGTNEKLF	GLCTLVAML	1
CASSLRTSGGTDTQYF	RFYKTLRAEQASQ	1
CASGIRSSYERYF	GILGFVFTL	1
CVSSDRQSLVQF	LPPIVAKEI	1
CASSLGVDEQFF	VTEHDTLLY	1
CASSPRDSKETQYF	KAFSPEVIPMF	1
CASSQQTGTIGGYTF	NLVPMVATV	1
CASSLGPATYEQYF	TPRVTGGGAM	1
CASSLAPSYEQYF	RAKFKQLL	1
CASSFRQGVNTGELFF	TPRVTGGGAM	1
CSARDKAGEGYNEQFF	GILGFVFTL	1
CSVGSGGTNEKLFF	GILGFVFTL	1
CASSEFVRDNQPQHF	RFYKTLRAEQASQ	1
CASSISSGSYNEQFF	GILGFVFTL	1
CSARVGVGNTIYF	GLCTLVAML	1
CASSWSGGGARDMQYF	VTEHDTLLY	1
CASSPGTGSYEQFF	LPRRSGAAGA	1
CSARDGSGNGYTF	GLCTLVAML	1
CASSAGGGSYNEQFF	NLVPMVATV	1
CSVGQFSSYEQYF	LPRRSGAAGA	1
CASSSSGTGAYEQYF	GILGFVFTL	1
CASSPEGTGSYEQYF	TPRVTGGGAM	1
CASSPGTGSYEQYF	LPRRSGAAGA	1
CASRVGGAGNSPLHF	TPRVTGGGAM	1
CASSLSGLAGEETQYF	CRVLCCYVL	1
CASSVDKGGPDTQYF	IIKDYGKQM	1
CASSQSPGGFQFF	GLCTLVAML	1
CVSSALASGGDEQFF	RFYKTLRAEQASQ	1
CASSQSPGGEQFF	GLCTLVAML	1
CASSRLAGGMDEQFF	RFYKTLRAEQASQ	1
CASSYETGGSYEQYF	ELAGIGILTV	1
CASSQDRWDVMSQNIQYF	VLFGLGFAI	1
CASSLLNTEAFF	LPRRSGAAGA	1
CASSIRTGGETQYF	PQPELPYPQPQ	1
CASSFRTGGSYEQYF	TPRVTGGGAM	1
CASSLIGEGTTEDEQFF	VTEHDTLLY	1
CASSFQGNTGELFF	SLFWNEPAI	1
CASSALASGTDTQYF	RFYKTLRAEQASQ	1
CASSIRSQETQYF	GILGFVFTL	1
CASSQTLNTEAFF	LPRRSGAAGA	1
CASSIRSTGELF	GILGFVFTL	1
CSVISGYGNQPQHF	LPRRSGAAGA	1
CASSRRTSGGTDTQYF	RFYKTLRAEQASQ	1
CASSLRSTDTQYF	PQPELPYPQPE	1
CASSPNTEAFF	RPHERNGFTVL	1
CSVGQGGTNEKLFF	GLCTLVAML	1
CASSQVPGSYEQYF	KLNTITPVV	1
CASKPARANEQFF	RFYKTLRAEQASQ	1
CASSLGNTEAFF	FLYNPLTRV	1
CASSPRTSGGTDTQYF	RFYKTLRAEQASQ	1
CASSLYSGPDQPQHF	FPRPWLHGL	1
CASSLGGLGQPQHF	ELAGIGILTV	1
CASSVASGTDTQYF	FLRGRAYGL	1
CSARSGVGNTIYF	GLCTLVAML	1
CASSLRTSGGDEQFF	RFYKTLRAEQASQ	1
CASSSRGNYEQFF	LPRRSGAAGA	1
CASSPRDSQETQYF	KAFSPEVIPMF	1
CASSHRASGGDTPHF	RFYKTLRAEQASQ	1
CASSLRTSGSHEQYF	PQPQLPYPQPQ	1
CASSLVVPQLPTYEQYF	VTEHDTLLY	1
CASSEGASGVGEQFF	RFYKTLRAEQASQ	1
CASSFSGRTDTQYF	LPRRSGAAGA	1
CASSLRQGINTGELF	TPRVTGGGAM	1
CASSLSGSSYEQYF	GILGFVFTL	1
CASSTRSGDTQYF	GILGFVFTL	1
CASSDRSSYEQYF	GILGFVFTL	1
CASSLSGQLDEQYF	ATDALMTGY	1
CASSVYSNQPQHF	GILGFVFTL	1
CASSLSWGGFYNEQF	TPRVTGGGAM	1
CASSHRGSGNTIYF	NLAQTDLATV	1
CASSMRSGYEQYF	GILGFVFTL	1
CASSSGAGEANEQYF	GLCTLVAML	1
CASSSHDWTGMNTEAFF	TPRVTGGGAM	1
CASSVGNTEAFF	YVLTWIVGA	1
CASSLVAGPYNEQFF	LPRRSGAAGA	1
CASSLGGSNYEQYF	ELAGIGILTV	1
CASSFGLNQPQHF	NLVPMVATV	1
CASSVLRGRNEPFF	RFYKTLRAEQASQ	1
CSVEGSRTENNQPQHF	GLCTLVAML	1
CSARLGVGNTIYF	GLCTLVAML	1
CASSQDSLGGSYNEQFF	LPRRSGAAGA	1
CASSLSSGPYNEQFF	VVLSWAPPV	1
CASSLMGRGPNTGELFF	GLCTLVAML	1
CASSYGVNTEAFF	FMLYLLTLM	1
CASSIRSSNEQFF	GILGFVFTL	1
CASSPRSTDTQYF	GILGFVFTL	1
CASSLTLQETQYF	CRVLCCYVL	1
CASSEVVFEQFF	CRVLCCYVL	1
CASSPGDEQFF	CRVLCCYVL	1
CSAYETSWNEQYF	LPRRSGAAGA	1
CASSLSDRGGDEQF	NLVPMVATV	1
CASSLTDPYEQYF	GLCTLVAML	1
CASSLLGGAGTDTQYF	GILGFVFTL	1
CASSIGAYGYTF	GILGFVFTL	1
CASRWSGGGARDTQNF	VTEHDTLLY	1
CASSTTSSTTSYEQYF	GLCTLVAML	1
CASSIYSNQPQHF	GILGFVFTL	1
CASSYQTGAIYGYTF	NLVPMVATV	1
CASSYIPGKQFF	TPRVTGGGAM	1
CASSQDLAGGLLSDTQYF	CRVLCCYVL	1
CASSIRSAYERYF	GILGFVFTL	1
CSVQEGNYGYTF	GLCTLVAML	1
CSARDSVGNGYTF	GLCTLVAML	1
CASSPTSGGYEQYF	GLCTLVAML	1
CASSSGTSGAGEQFF	RFYKTLRAEQASQ	1
CASSYATGIGNYGYTF	NLVPMVATV	1
CASSIRSGYEQYF	GILGFVFTL	1
CSARDRVGNTIYF	GLCTLVAML	1
CASSRSPGGTQYF	GLCTLVAML	1
CAVGTGGTNEKLF	GLCTLVAML	1
CASSPDSFSGANVLTF	FRCPRRFCF	1
CASSIKGYNERF	FPRPWLHGL	1
CASSPNGGSSYNEQFF	GILGFVFTL	1
CASSFRTVNSYEQYF	TPRVTGGGAM	1
CASSLRATDTQYF	PQPELPYPQPE	1
CTSSIKGYNEQF	FPRPWLHGL	1
CASSGWDNEQFF	CRVLCCYVL	1
CASSFRSSYEQYF	GILGFVFTL	1
CSARDSTGKGYTF	GLCTLVAML	1
CASSIGLYGYTF	GILGFVFTL	1
CASSQGISTGELFF	VLNPFIYTL	1
CASSLGWGYEQYF	MLNIPSINV	1
CASSLSGLDNEQFF	CRVLCCYVL	1
CSVPSLLNTEAF	GLCTLVAML	1
CASSLYSGGDKEQYF	FPRPWLHGL	1
CASSFTSGGYNEQFF	CRVLCCYVL	1
CASSVRTSGSTDTQYF	LPRRSGAAGA	1
CASSLGQGQPQHF	ELAGIGILTV	1
CASSFDSYEQYF	LPRRSGAAGA	1
CVSSESRMGSQANYGYTF	KAFSPEVIPMF	1
CASSSRTGELF	KRWIILGLNK	1
CASSLVFGTAGGQQF	TPQDLNTML	1
CASSFQGLGSPLHF	EAAGIGILTV	1
CASSLEGSTDTQYF	LPRRSGAAGA	1
CASSIRTGGDTQYF	PQPELPYPQPE	1
CASSFRSTDTQYF	PQPQLPYPQPQ	1
CASSFGTFETQYF	GLCTLVAML	1
CASSLSAYEQYF	LPRRSGAAGA	1
CASSTGQKNTEAFF	CRVLCCYVL	1
CASSPGDEQFF	LPRRSGAAGA	1
CASSSSSQGAQETQYF	TPRVTGGGAM	1
CTSSLVFGTAGGRQF	TPQDLNTML	1
CASSFRSQETQYF	GILGFVFTL	1
CASSSRSPYEQYF	GILGFVFTL	1
CASSLSGSYEQFF	LPRRSGAAGA	1
CASSLSGVAYGYTF	ILTGLNYEA	1
CASTTGDEQFF	CRVLCCYVL	1
CASSPSARGNQPQHF	RFYKTLRAEQASQ	1
CASSFQGYTEAF	NLVPMVATV	1
CASSVRSTGALF	GILGFVFTL	1
CASSLAGSYEQYF	LPRRSGAAGA	1
CASSLGQGENEQFF	LPRRSGAAGA	1
CASSPRTSGGDEQYF	RFYKTLRAEQASQ	1
CASSQAGLEAYNEQFF	GLCTLVAML	1
CASSVRTSGGTDTQYF	RFYKTLRAEQASQ	1
CASSPAGSNYGYTF	FLYNPLTRV	1
CASSPGTISYEQYF	VLNPFIYML	1
CASSARSTGELFF	GILGFVFTL	1
CASSPDRTQEQYF	SFHSLHLLF	1
CASSVLRGRNEQFF	RFYKTLRAEQASQ	1
CSATSRQGGLEQYF	HPKVSSEVHI	1
CASSKRTSGGADTQYF	RFYKTLRAEQASQ	1
CSVEDISGYNEQFF	GILGFVFTL	1
CATTGSYGYTF	KAFSPEVIPMF	1
CSAAGDRGADTQYF	LLWNGPMAV	1
CASGVRSAYEQYF	GILGFVFTL	1
CASSIRATGELFF	GILGFVFTL	1
CASSLWGGDFSQERF	FPRPWLHGL	1
CASTGGGYGYTF	KAFSPEVIPMF	1
CASSSSYEQYF	LPRRSGAAGA	1
CNARGQAITEKLFF	GLCTLVAML	1
CSARDSPGNGYTF	GLCTLVAML	1
CASSLAGGTEAFF	LLLNMLIVL	1
CSARDRGIGNTIYF	GLCTLVAML	1
CASSSAFYGYTF	NLVPMVATV	1
CASSLRFTDTQYF	PQPELPYPQPQ	1
CASSRLAGGTDEQFF	RFYKTLRAEQASQ	1
CASSKRSTGELFF	GILGFVFTL	1
CASSQGVNTGELFF	FLCMKALLL	1
CASSQTGFGNQPQHF	NLVPMVATV	1
CASSTGAYGYTF	GILGFVFTL	1
CVSSLAGTQETQYF	KAFSPEVIPMF	1
CASSLRSGDTQYF	PQPELPYPQPQ	1
CASSVRSTDTQYF	PQPELPYPQ	1
CASSQSPGDTQYF	GLCTLVAML	1
CASSVVGNEQFF	GLCTLVAML	1
CASSFLGSSSYEQYF	EAAGIGILTV	1
CASSQDRTDGNTIYF	GLCTLVAML	1
CASSPDGGSYNEQFF	LPRRSGAAGA	1
CASSGQDYGYTF	KAFSPEVIPMF	1
CASSELASGISEQFF	RFYKTLRAEQASQ	1
CASSYGSYNEQFF	FLCMKALLL	1
CSARDRASTDTQYF	LPRRSGAAGA	1
CASSSANYGYTF	GILGFVFTL	1
CSARDRTSGSYEQYF	LPRRSGAAGA	1
CASSPNREKTQYF	SFHSLHLLF	1
CASSLYSGLDQPQHF	FPRPWLHGL	1
CSATSRRGGREQYF	HPKVSSEVHI	1
CASSSKTSGGTDTQYF	RFYKTLRAEQASQ	1
CSARDTTGNGYTF	GLCTLVAML	1
CASSIRSLDIQYF	GILGFVFTL	1
CASSQEIPYEQFF	GLCTLVAML	1
CASRAGTSGTGELFF	RFYKTLRAEQASQ	1
CASSSGQSYEQYF	LPRRSGAAGA	1
CASSLIASGGYNEQF	RAKFKQLL	1
CASRVQGRDNEQF	RPRGEVRFL	1
CASSLIGEGTTEDEQFF	LPRRSGAAGA	1
CASSYGIAGKETQYF	GILGFVFTL	1
CASSLGPLTGLGPEAF	HPKVSSEVHI	1
CASSLRDGFTTGELFF	TPRVTGGGAM	1
CTSSQSPGGTQYF	GLCTLVAML	1
CASSLRSAYEQYF	GILGFVFTL	1
CSVPSTVQETQYF	GLCTLVAML	1
CASSTRSAYEQYF	GILGFVFTL	1
CASGFQGLGSPLHF	EAAGIGILTV	1
CASSARFTDTQYF	PQPELPYPQPQ	1
CASNSSGTGAYEQYF	GILGFVFTL	1
CASSARASGGDEQFF	RFYKTLRAEQASQ	1
CASSVYSGGYNEQFF	GILGFVFTL	1
CASSLAPGYEQYF	LPRRSGAAGA	1
CASSQDSYEQYF	RPHERNGFTVL	1
CASSKRSGIEQYF	GILGFVFTL	1
CAWSVLGSTDTQYF	GILGFVFTL	1
CASSQDSGSNYGYTF	LPRRSGAAGA	1
CASSDLAVSYNEQFF	VTEHDTLLY	1
CSAADRASGIEQYF	HPKVSSEVHI	1
CASSLGPTVPGNAIYF	HPKVSSEVHI	1
CASSLLPGTGELFF	RPHERNGFTVL	1
CASSQDGSGGLGEQYF	GLCTLVAML	1
CASRTGISNTGELF	ATDALMTGY	1
CASSIRNSYNEQF	GILGFVFTL	1
CASSQDSFSGANVLTF	LPRRSGAAGA	1
CASSSGGTEAFF	NLVPMVATV	1
CASSLGGTYEQYF	GLCTLVAML	1
CSARDRVGNGYTF	GLCTLVAML	1
CASSIRSSETQYF	GILGFVFTL	1
CASSLGGSGYEQYF	LPRRSGAAGA	1
CAWSAGAAYEQFF	LPRRSGAAGA	1
CASSTWSTDTQYF	GILGFVFTL	1
CASSPRGGAYNEQFF	LPRRSGAAGA	1
CTSSSTITGMGDSGNTIYF	TPQDLNTML	1
CASSPVSNEQFF	CRVLCCYVL	1
CASSPRSSDTQYF	GILGFVFTL	1
CASSMGSHGYTF	GILGFVFTL	1
CASSLGQGGYEQFF	LPRRSGAAGA	1
CASSDRASGVGEQFF	RFYKTLRAEQASQ	1
CASSLGGRASTDTQYF	GLCTLVAML	1
CSARGQATTEKLFF	GLCTLVAML	1
CASRRGTSGTGELFF	RFYKTLRAEQASQ	1
CASSLGLNTIYF	TPQDLNTML	1
CASSLEGLYNEQFF	LPRRSGAAGA	1
CASSLRTDVYNEQFF	CRVLCCYVL	1
CSARDEVGNTIYF	GLCTLVAML	1
CASSQGGSDTQYF	VTEHDTLLY	1
CASSPQGLGQPQHF	EAAGIGILTV	1
CASSQGHGPFNQPQHF	GLCTLVAML	1
CASSQSTGSSYEQYF	GILGFVFTL	1
CASSVDKGGTDAQYF	IIKDYGKQM	1
CSVEGFRTENNQPQHF	GLCTLVAML	1
CASSLAQGGETQYF	FWIDLFETIG	1
CASSAPGLLEQHF	LPRRSGAAGA	1
CASSGDVFNYGYTF	RPHERNGFTVL	1
CASSQDFRGGYEQYF	GLCTLVAML	1
CASSLWSGASNEQF	FPRPWLHGL	1
CASSGRSPYEQDF	GILGFVFTL	1
CASSAGQGYEQYF	LLWNGPMAV	1
CAWSAGAAYEQYF	LPRRSGAAGA	1
CASSRTLNTEAFF	VTEHDTLLY	1
CVSGWGSQPQHF	AVFDRKSDAK	1
CATSGSYEQYF	ELAGIGILTV	1
CASKLYTGGDQPQHF	FPRPWLHGL	1
CASSLWSGIADTQYF	FPRPWLHGL	1
CASSFYSNQPQHF	GILGFVFTL	1
CASSLYGGGEQPQHF	FPRPWLHGL	1
CSATNRDRGLEQYF	HPKVSSEVHI	1
CASSLEGSYEQYF	RAKFKQLL	1
CASSLGSATGELFF	LPRRSGAAGA	1
CASSLAHGYEQYF	LPRRSGAAGA	1
CSAPSLLNTEAF	GLCTLVAML	1
CASSRTGAGETQYF	LPRRSGAAGA	1
CASSLHTQGARTEAFF	TPRVTGGGAM	1
CSASTGLTEAFF	ELAGIGILTV	1
CASSFGGGTYEQYF	PQPELPYPQPE	1
CASSAASGTDTQYF	FLRGRAYGL	1
CASRTGAANIYEQYF	TPRVTGGGAM	1
CASSPSGGVYGYTF	KLWASPLHV	1
CASSTYSTDTQYF	GILGFVFTL	1
CASRAPGLAFQETQYF	RFYKTLRAEQASQ	1
CASGVQGLGQPQHF	EAAGIGILTV	1
CASSFPDTQYF	CRVLCCYVL	1
CASSQTGLNTEAFF	GILGFVFTL	1
CASSGRSGETQYF	GILGFVFTL	1
CASSPARNTEAFF	TPRVTGGGAM	1
CASSPPAGSAYNEQFF	LPRRSGAAGA	1
CASSQCPGGEQYF	GLCTLVAML	1
CASSIRSAGELF	GILGFVFTL	1
CASSPTGLGQPQHF	EAAGIGILTV	1
CASSQATGYEQYF	KLWASPLHV	1
CASSFGSTDTQYF	GILGFVFTL	1
CSVGQGGTNEKLF	GLCTLVAML	1
CASSARTSGGADTQYF	RFYKTLRAEQASQ	1
CASSLYGGPEQPQHF	FPRPWLHGL	1
CASSEMATGLRYTF	RFYKTLRAEQASQ	1
CASTTGQKNTEAFF	CRVLCCYVL	1
CASSLGLSEQYF	LPRRSGAAGA	1
CASSLWPGASNEQF	FPRPWLHGL	1
CASSLGFGYEQFF	MLNIPSINV	1
CASSFEGLLSTDTQYF	CTELKLSDY	1
CASTGGQYGYTF	KAFSPEVIPMF	1
CASSIRSAIEQYF	GILGFVFTL	1
CASSSVNEQYF	NLVPMVATV	1
CASSRRTSGSLDTQYF	RFYKTLRAEQASQ	1
CASSLSGLYNEQFF	CRVLCCYVL	1
CASSIRSAHEQYF	GILGFVFTL	1
CASSLRRGFTTGELFF	TPRVTGGGAM	1
CTSSEDKGGGDTQYF	IIKDYGKQM	1
CASSETATGLRYTF	RFYKTLRAEQASQ	1
CASSPPGENYNEQFF	GILGFVFTL	1
CASSQDGSGGLGEQFF	GLCTLVAML	1
CASSSGTVNTGELF	ATDALMTGY	1
CASSFLGTASYEQYF	EAAGIGILTV	1
CASSPTGQLETQYF	ATDALMTGY	1
CASSMRSAYEQYF	GILGFVFTL	1
CASSSAHYGYTF	NLVPMVATV	1
CASSFRAGYNEQFF	VTEHDTLLY	1
CASSVRSTGELFF	GILGFVFTL	1
CATGTGDSNQPQHF	RPHERNGFTVL	1
CASSLLGTYSYNEQFF	CRVLCCYVL	1
CASSPGTNAYEQYF	KRWIILGLNK	1
CASSLSGSYEQFF	VTEHDTLLY	1
CASRGRSSYEHYF	GILGFVFTL	1
CASTSWGETQCF	GILGFVFTL	1
CASSDLASGTDTQYF	RFYKTLRAEQASQ	1
CASSLVQGYEQYF	LPRRSGAAGA	1
CASSLATEQFF	AVGSYVYSV	1
CASSIRSNTEAFF	GILGFVFTL	1
CAGSLGGGSYEQYF	NLVPMVATV	1
CASSYGGGGYEQFF	VTEHDTLLY	1
CASSYSSGTEAFF	ALYGSVPVL	1
CASSGGTGAYEQYF	LLWNGPMAV	1
CASSLGSMPETQYF	TPRVTGGGAM	1
CATSSASGRGSDTQYF	GLCTLVAML	1
CASSAGTGYNEQFF	LPRRSGAAGA	1
CASSIRSSAEAFF	GILGFVFTL	1
CSVEGFRTENKQPQHF	GLCTLVAML	1
CASSSLSTEAF	RAKFKQLL	1
CSVGSVGTNEKELF	GLCTLVAML	1
CSVPITVQETQYF	GLCTLVAML	1
CASSVVGNEQYF	GLCTLVAML	1
CASSQGQGYEQYF	MLNIPSINV	1
CASSRLTSGTDTQYF	RFYKTLRAEQASQ	1
CASSGRSTDTQYF	LASYFFWGL	1
CAWTLAGRDTGELFF	GLCTLVAML	1
CSAPYRVEGRIVNEQYF	GILGFVFTL	1
CASSITLGTGGVEQYF	NLVPMVATV	1
CATSSHAGETQYF	FRCPRRFCF	1
CASSSTGEGTDTQDF	GLCTLVAML	1
CASSYQTGASYGYTF	NLVPMVATV	1
CASSIGGLGTEAF	EAAGIGILTV	1
CSVEDISGYNEQYF	GILGFVFTL	1
CASSVGGVTYNEQFF	LLWNGPMAV	1
CASSSLNTEAF	RAKFKQLL	1
CASSPGLAGTGELFF	RFYKTLRAEQASQ	1
CASSQLAYSYNEQFF	CRVLCCYVL	1
CASSLAWTSGSYEQYF	LPRRSGAAGA	1
CASSLGTGNNEQFF	RAKFKQLL	1
CASSLRRGPDTGELFF	VTEHDTLLY	1
CASSQQGLGTEAF	EAAGIGILTV	1
CASSQSPGGTRYF	GLCTLVAML	1
CASSIRFTDTQYF	PQPELPYPQPE	1
CASSLSQGGDTQYF	FWIDLFETIG	1
CASSYGGAYEQYF	NLNCCSVPV	1
CASSIRTSGGTDTQYF	RFYKTLRAEQASQ	1
CATSREGGETQYF	FRCPRRFCF	1
CSARLRKLSGNTIYF	GLCTLVAML	1
CASSARTSGGQPQHF	RFYKTLRAEQASQ	1
CASSPTSSTHSYEQYF	GLCTLVAML	1
CASSQAQGMGNSPLHF	RAKFKQLL	1
CSVEAGTYEQYF	LPRRSGAAGA	1
CTSSEGRDQETQYF	FPRPWLHGL	1
CASSQRDSQETQYF	RYPLTFGWCF	1
CVSSLVGPPGELF	LPPIVAKEI	1
CASSVAGGDEQFF	GLCTLVAML	1
CASSPAFSRHYEQCF	LPRRSGAAGA	1
CASSQGAAYEQYF	LLWNGPMAV	1
CASSLSGLENEQFF	CRVLCCYVL	1
CSARDRTGNGYTF	GLCTLVAML	1
CASSLNPRQGRDEQYF	VTEHDTLLY	1
CASSSRDRGHYEQYF	TPRVTGGGAM	1
CASSLSSYNEQFF	GILGFVFTL	1
CASSIRYTDTQYF	PQPELPYPQPQ	1
CASSLLGISTYNEQFF	TPRVTGGGAM	1
CSARDRVGNGHTF	GLCTLVAML	1
CASSYGVGTEAFF	GILGFVFTL	1
CAGTGTAYGYTF	KAFSPEVIPMF	1
CASSFDRPGDEQYF	CRVLCCYVL	1
CAWSVSGLGYGYTF	ELAGIGILTV	1
CSVQRRADEQFF	LLWNGPMAV	1
CASSQSPGGEQYF	GLCTLVAML	1
CASSPEGTGSYEQYF	RPHERNGFTVL	1
CASTLGGNTGELFF	GLCTLVAML	1
CASSLQGMGQPQHF	EAAGIGILTV	1
CASSARSTDTQYF	GILGFVFTL	1
CASTFGGLGQPQHF	EAAGIGILTV	1
CASTHAGRPYEQYF	LPRRSGAAGA	1
CASSTGSYGYTF	GILGFVFTL	1
CASSPRQGKEQF	LPPIVAKEI	1
CASSYGLEQYF	YLWPPVQLA	1
CASSQDRVDTQYF	LPRRSGAAGA	1
CASSLALGVAKNIQYF	TPRVTGGGAM	1
CAWSRGAVEQFF	GLCTLVAML	1
CASSSRQGNLIDEQFF	TPRVTGGGAM	1
CASSEGRDQETQYF	FPRPWLHGL	1
CASSHRQGGTGELF	HSKKKCDEL	1
CASSFRHTDTQYF	PQPQLPYPQPQ	1
CASRWSGGGARDPQYF	VTEHDTLLY	1
CASGLVPGGVVYEQYF	GILGFVFTL	1
CASSLAPGATNEKLFF	NLVPMVATV	1
CAGTLAGGTDTQYF	VTEHDTLLY	1
CASSPRTDGYTF	LPRRSGAAGA	1
CASSQVMVGAVDGYTF	EAAGIGILTV	1
CASSTGLYGYTF	GILGFVFTL	1
CSVGSDGTNEKLFF	GLCTLVAML	1
CASSLSRGPYNEQFF	GLCTLVAML	1
CASSFSKNTEAF	TPQDLNTML	1
CASSQGTSGSYEQYF	LPRRSGAAGA	1
CATSERGSTDTQYF	LPRRSGAAGA	1
CASSSFLSSGETQYF	KAFSPEVIPMF	1
CASSLVGAEAFF	LLSIIFFPA	1
CASSLSGNEQYF	LPRRSGAAGA	1
CASSLSGDYGYTF	GLCTLVAML	1
CASSQVPGGYEQYF	NLNCCSVPV	1
CASSPLTSATDTQYF	RFYKTLRAEQASQ	1
CASSIRSTDTQYF	LPRRSGAAGA	1
CASSIGTASTDTQYF	RPHERNGFTVL	1
CASSLSGSYEQYF	VTEHDTLLY	1
CASSFRFTDTQYF	PQPELPYPQ	1
CASSLVAGGGETQYF	GILGFVFTL	1
CASSSRSSYEQYF	EAAGIGILTV	1
CSARDRESTDTQYF	LPRRSGAAGA	1
CASSPDLSSGNTIYF	FRCPRRFCF	1
CASGWGSQPQHF	AVFDRKSDAK	1
CASSFRQGANTGELFF	LPRRSGAAGA	1
CASSLSYEQYF	FLTVFSHFM	1
CARSPNGGSSYNEQFF	GILGFVFTL	1
CSVGSAGTNEKLFF	GLCTLVAML	1
CASSQDISGGLLSDTQYF	CRVLCCYVL	1
CASSLTGAGTDTQYF	GLCTLVAML	1
CASSYSEGTEAFF	NLVPMVATV	1
CASSKRSTDTQYF	GILGFVFTL	1
CASSARATDTQYF	GILGFVFTL	1
CASSQDFRGGYEQDF	GLCTLVAML	1
CASSLGGGGYEQYF	LPRRSGAAGA	1
CASSIKGYNEQF	FPRPWLHGL	1
CASSQGSYGYTF	GILGFVFTL	1
CASSGRSGVEQFF	GILGFVFTL	1
CSARDKTGNGYTF	GLCTLVAML	1
CASRPRRAGGDRELFF	GLCTLVAML	1
CASTGGSYGYTF	KAFSPEVIPMF	1
CASSFGQGYEQYF	LIFNMFYWI	1
CASSPDSDSYEQYF	GILGFVFTL	1
CASSFLGADTQYF	LPRRSGAAGA	1
CATSRVAGEVQYF	FRCPRRFCF	1
CASSLYSGYDQPQHF	FPRPWLHGL	1
CASSFGSYNEQFF	LPRRSGAAGA	1
CASSLGGGSYEQYF	LPRRSGAAGA	1
CSVEGFQTENNQPQHF	GLCTLVAML	1
CASSRTLNTEAFF	LPRRSGAAGA	1
CASSALASGDTQYF	RFYKTLRAEQASQ	1
CASSLGQGGETQYF	FWIDLFETIG	1
CASSLRYTDTQYF	PQPQLPYPQPQ	1
CASSIRDTDTQYF	PQPELPYPQPQ	1
CASSSQGNQPQHF	CRVLCCYVL	1
CASSPTGGGTGELFF	VTEHDTLLY	1
CASSGRAAGELFF	GILGFVFTL	1
CASSIVNEAFF	NLVPMVATV	1
CVSSLFGSPEQPQHF	FPRPWLHGL	1
CASSGQEYGYTF	KAFSPEVIPMF	1
CASSLGSTSYEQYF	LPRRSGAAGA	1
CASRMQGRDNEQF	RPRGEVRFL	1
CASSRRGTGELFF	NLVPMVATV	1
CASSWSGGGPRDTQNF	VTEHDTLLY	1
CASSLHSRGARTEAFF	TPRVTGGGAM	1
CASRPDRGHTQYF	SFHSLHLLF	1
CASSLGGHEQYF	LPRRSGAAGA	1
CASSLVGLAGQETQYF	CRVLCCYVL	1
CASSFRSTDTQYF	PQPELPYPQPE	1
CASSSVDRSSYEQYF	FPRPWLHGL	1
CASSVGSYGYTF	GILGFVFTL	1
CASSQSPDGTQYF	GLCTLVAML	1
CASSSYGGSNQPQHF	LPRRSGAAGA	1
CASGIGGYGYPF	GILGFVFTL	1
CASRSGVGNTIYF	GLCTLVAML	1
CASSPSGQLETQYF	ATDALMTGY	1
CASSLAGNTEAFF	LPRRSGAAGA	1
CASSLAYSGANVLTF	FLCMKALLL	1
CSATSRDSALEQYF	HPKVSSEVHI	1
CASSFGSTGELFF	LPRRSGAAGA	1
CASSLTEAGNQPHHF	RAKFKQLL	1
CASSYSGGYEQYF	NLNCCSVPV	1
CASSPRTSGTDTQYF	RFYKTLRAEQASQ	1
CASSPRTSGPYEQYF	RFYKTLRAEQASQ	1
CASSPRTSGRSYEQYF	LPRRSGAAGA	1
CASSLAGTDTQYF	TPRVTGGGAM	1
CASSFQGLGTEAF	ELAGIGILTV	1
CASSLGPASYEQYF	TPRVTGGGAM	1
CASSILGSYNEQFF	FLCMKALLL	1
CSATARQGGMEQYF	HPKVSSEVHI	1
CASSFQTGASYGYTF	NLVPMVATV	1
CASSPDRANTQYF	SFHSLHLLF	1
CASSLGGGSYEQYF	NLVPMVATV	1
CASSLRGTGELF	FLKEKGGL	1
CASSLRTVSSYEQYF	TPRVTGGGAM	1
CASSVVGGDEQYF	GLCTLVAML	1
CASSIGYYGYTF	GILGFVFTL	1
CASSYYSGGSSYNEQF	TPGPGVRYPL	1
CASRQSPGGTQYF	GLCTLVAML	1
CASSSTYEQYF	LPRRSGAAGA	1
CASSIRSSGELFF	GILGFVFTL	1
CASSLSPGYEQYF	LPRRSGAAGA	1
CAGSLSWGGFYNEQF	TPRVTGGGAM	1
CASSVRSTDTQYF	PQPELPYPQPQ	1
CASSELASGGDEQFF	RFYKTLRAEQASQ	1
CASSLQGSYEQYF	VVMSWAPPV	1
CASSLIGVSSYNEQFF	TPRVTGGGAM	1
CASSEVLFEQFF	CRVLCCYVL	1
CAWSVAGDTDTQYF	GILGFVFTL	1
CASSFLSADTQYF	GILGFVFTL	1
CASSQDLNEQYF	VLNPFIYML	1
CASSTRSSYEQYF	GILGFVFTL	1
CASSPRSDGYTF	LPRRSGAAGA	1
CSARDRTGNTIYF	GLCTLVAML	1
CSVPIAVQETQYF	GLCTLVAML	1
CASSLVGPPGELF	LPPIVAKEI	1
CASRWGLAGELFF	CRVLCCYVL	1
CASSPNRNTEAFF	RPHERNGFTVL	1
CASSMRSTGELFF	GILGFVFTL	1
CATSSHVGETQYF	FRCPRRFCF	1
CASSLEEASRMNTEAFF	FRCPRRFCF	1
CASSEDKGGADTQYF	IIKDYGKQM	1
CASSPIAGSSYEQYF	GILGFVFTL	1
CASSSQTGPYSNQPQHF	MMPFSIVYI	1
CASSIKGYNELF	FPRPWLHGL	1
CASSYGGYEQYF	GILGFVFTL	1
CASSLTGSEAF	IPSINVHHY	1
CASSQGARGGNQPQHF	RFYKTLRAEQASQ	1
CSARDRIGNGYTF	GLCTLVAML	1
CASSTGNYGYTF	ALYGFVPVL	1
CASTGGRGSPLHF	EIYKRWII	1
CSAPYRVEGRIVNEQFF	GILGFVFTL	1
CASRLGPGQPYEQYF	TPRVTGGGAM	1
CASSQGTPRDEQYF	CRVLCCYVL	1
CASSQEGGGGYEQYF	FLYALALLL	1
CASRLGPGQPYERYF	TPRVTGGGAM	1
CASSQTGYSNQPQHF	LPRRSGAAGA	1
CSARDRTSGRYEQFF	LPRRSGAAGA	1
CASSFRTVSSYEQYF	TPRVTGGGAM	1
CASSLRQGANTGELF	TPRVTGGGAM	1
CSARSETGNTIYF	GLCTLVAML	1
CASSIGYEQFF	GILGFVFTL	1
CASSVAGTPNTEAFF	TPRVTGGGAM	1
CASSQDRGPDTQYF	FPRPWLHGL	1
CASSLRAGGNHEQYF	PQPELPYPQPE	1
CASSVSGGQVTDTQYF	TPGPGVRYPL	1
CASSLMGRGPNTGVLFF	GLCTLVAML	1
CASSPLSGNEQFF	LPRRSGAAGA	1
CASSLGQGTDTQYF	LPRRSGAAGA	1
CASSLMGAEAFF	NLFNRYPAL	1
CASSFSSSYNEQFF	GILGFVFTL	1
CASSSLDTEAF	RAKFKQLL	1
CSVVGQGHEQYF	LPRRSGAAGA	1
CASSLSLAGRERFF	LPRRSGAAGA	1
CASSGRNYGYTF	KAFSPEVIPMF	1
CASSLTGAGDQPQHF	RAKFKQLL	1
CASSLMGLAGEETQYF	CRVLCCYVL	1
CASSPWGQTASSYNEQYF	GILGFVFTL	1
CASSWSGGGARDTQYF	NLVPMVATV	1
CSADRGRTDTQYF	LPRRSGAAGA	1
CVSRSLVSTGELFF	RFYKTLRAEQASQ	1
CASTLAGGTDTQYF	NLVPMVATV	1
CASSLAPGTTNEKLF	NLVPMVATV	1
CSARLRELSGNTIYF	GLCTLVAML	1
CASSAGRVSPGELF	GLCTLVAML	1
CASSLLQGPSYEQYF	GILGFVFTL	1
CASRPRRAEGDRELFF	GLCTLVAML	1
CASSALTSGGDEQFF	RFYKTLRAEQASQ	1
CASSYGLEQFF	FRCPRRFCF	1
CASSVYSTDTQYF	RLGPYLEFL	1
CASSLWGGIADTQYF	FPRPWLHGL	1
CASSPGTSGVGEQFF	RFYKTLRAEQASQ	1
CASRAGTSNTGELF	ATDALMTGY	1
CASSLGQDTDTQYF	GILGFVFTL	1
CASSLGTGHNEQFF	GILGFVFTL	1
CASSDQGLGTEAF	EAAGIGILTV	1
CASSVRAGETQYF	GILGFVFTL	1
CASSLSGTAYGYTF	LPRRSGAAGA	1
CASSLEAGDQPQHF	LPRRSGAAGA	1
CSAPTSGGSNEQFF	LLWNGPMAV	1
CASSQEIPYEQYF	GLCTLVAML	1
CASSSTSSTTSYEQYF	GLCTLVAML	1
CASSLEGGGYEQYF	LPRRSGAAGA	1
CSAGTGGTNEQF	GLCTLVAML	1
CASSSVNEQFF	LPRRSGAAGA	1
CASSQESGGGYEQFF	VTEHDTLLY	1
CASSFGQGQPQHF	ELAGIGILTV	1
CAGTLAGGTDTQYF	LPRRSGAAGA	1
CASSPGLAGAHEQFF	LPRRSGAAGA	1
CASSIGSYGYTF	GILGFVFTL	1
CASGKGDTEAFF	KLMNIQQQL	1
CASSFGQGNTEAFF	GLCTLVAML	1
CASSPRTSGSDTQYF	LPRRSGAAGA	1
CASSTFGATQETQYF	TPGPGVRYPL	1
CASSLAPGATNEKLF	NLVPMVATV	1
CASSRLTSGGSDTQYF	RFYKTLRAEQASQ	1
CASSFRSGINTGELFF	TPRVTGGGAM	1
CASSIGIYGYTF	GILGFVFTL	1
CASSLLGRAGTDTQYF	GILGFVFTL	1
CASSWGLAGEEQFF	GILGFVFTL	1
CASSSRNTGELFF	LPRRSGAAGA	1
CASRASTGSGNTIYF	TPQDLNTML	1
CASSLAYEQFF	GILGFVFTL	1
CASSLGPGKRETQYF	GLCTLVAML	1
CTSSDRQSLVQF	LPPIVAKEI	1
CASSALASGGDTQYF	RFYKTLRAEQASQ	1
CASSPPSGPVRNEQYF	LPRRSGAAGA	1
CASSYGQNTGELF	GILGFVFTL	1
CASSQEGGGEGQPQHF	TPQDLNTML	1
CASSLSVGSGGTNEKLF	GLCTLVAML	1
CASSLTEAGNQPHQF	RAKFKQLL	1
CASSLAQAGETQYF	FWIDLFETIG	1
CASSIRASNEQFF	GILGFVFTL	1
CASSFSSTDTQYF	GILGFVFTL	1
CASTSGDEQFF	CRVLCCYVL	1
CASSNGAYGYTF	GILGFVFTL	1
CASSFMGTSSYEQYF	EAAGIGILTV	1
CASSSGGNEQFF	GLCTLVAML	1
CASRPRRAGGDQELFF	GLCTLVAML	1
CASGLGANTIYF	TPQDLNTML	1
CASSLRSTDTQYF	PQPQLPYPQPQ	1
CAWSISDLAKNIQYF	NLVPMVATV	1
CASSGQNYGYTF	KAFSPEVIPMF	1
CASSISSSSYNEQFF	GILGFVFTL	1
CATGTGDSNQPQHF	EPLPQGQLTAY	1
CASSLRTSGGADTQYF	RFYKTLRAEQASQ	1
CASSQFVSGSYNEQFF	LPRRSGAAGA	1
CASHYGGSSYEQYF	NLVPMVATV	1
CASSQRASYEQYF	GILGFVFTL	1
CASSLLIYNEQFF	LPRRSGAAGA	1
CASSAGTGGYEQYF	GLCTLVAML	1
CASRGRSSYEQYF	GILGFVFTL	1
CASSLGSGNYGYTF	IVTDFSVIK	1
CASSLGWGAEQFF	LPRRSGAAGA	1
CASSEETGEGGHEQFF	GLCTLVAML	1
CSARSEVGNTIYF	GLCTLVAML	1
CASSARTSGGSDTQYF	RFYKTLRAEQASQ	1
CSATSGSYEQYF	LPRRSGAAGA	1
CASSQSPGGIQYF	LPRRSGAAGA	1
CASSIRSSEEQYF	GILGFVFTL	1
CASSQDSGTNYGYTF	LPRRSGAAGA	1
CASTSWGETQYF	GILGFVFTL	1
CASSSTITGMGVSGNTIYF	TPQDLNTML	1
CASRQEGGGDGQPQHF	TPQDLNTML	1
CASGLSDRGGDEQF	NLVPMVATV	1
CASSAQGAYGYTF	LLWNGPMAV	1
CASSSSQADEQYF	LPRRSGAAGA	1
CASSPTGGNTGELFF	LPRRSGAAGA	1
CSAPTSGGHNEQFF	LLWNGPMAV	1
CASSQGAYGYTF	GILGFVFTL	1
CASSSRQGNLIDEQYF	TPRVTGGGAM	1
CASSWSGGGARDTKNF	VTEHDTLLY	1
CASSLGGAQETQYF	TPRVTGGGAM	1
CASSQALPYGQYF	NLVPMVATV	1
CASSQHYTGENTEAFF	GILGFVFTL	1
CASSDRQSLVQF	LPPIVAKEI	1
CASSLGTSSTDTQYF	VLNYFKPYL	1
CASSQLTSGTDTQYF	RFYKTLRAEQASQ	1
CASSPSGGSYGYTF	NLNCCSVPV	1
CASSHMASGGDTQYF	RFYKTLRAEQASQ	1
CASSPLTSGTDTQYF	RFYKTLRAEQASQ	1
CASSPRSADTQYF	GILGFVFTL	1
CASSIRAAETQYF	GILGFVFTL	1
CASSPRASGGDEQFF	RFYKTLRAEQASQ	1
CASSLAWGGFYNEQF	TPRVTGGGAM	1
CASSQERGNEQFF	GLCTLVAML	1
CSATSRDRALEQYF	HPKVSSEVHI	1
CASSLWAGETEAF	FPRPWLHGL	1
CASSLRDGGLNYGYTF	GLCTLVAML	1
CASSYIPGEQYF	TPRVTGGGAM	1
CASSLGQGRRDEQFF	GILGFVFTL	1
CASTLIGLAGQDTQYF	CRVLCCYVL	1
CSVLAGGGYEQYF	LPRRSGAAGA	1
CASSSTGLNTEAFF	GLCTLVAML	1
CASSPDREKTQYF	SFHSLHLLF	1
CASSARSAYEQYF	GILGFVFTL	1
CASSMGGDEQFF	LPRRSGAAGA	1
CASSPLAFYFNEQF	GILGFVFTL	1
CASSLYAGPDQPQHF	FPRPWLHGL	1
CASSTGQKNEKLFF	CRVLCCYVL	1
CASSPRQGGTGELF	HSKKKCDEL	1
CASSLAPGTTNEKLFF	NLVPMVATV	1
CASSLMGRGPNTGELVF	GLCTLVAML	1
CASSLGSSYEQYF	YLEPGPVTA	1
CASSPLGGSSYEQYF	LPRRSGAAGA	1
CASSLTGPGDQPQHF	RAKFKQLL	1
CASSRLAGGMDEQYF	RFYKTLRAEQASQ	1
CASSLATGVAKNIQYF	TPRVTGGGAM	1
CASSQSRGSGNTIYF	HSKKKCDEL	1
CASSAGTVSYEQYF	LLWNGPMAV	1
CASSPEGGRTGELFF	CRVLCCYVL	1
CASSLTDPYEQFF	GLCTLVAML	1
CASSIRTSGAHEQYF	PQPELPYPQPQ	1
CASSLGEGTEAFF	LPRRSGAAGA	1
CASSIRGANQPQHF	GILGFVFTL	1
CSVGTGGTNEKLFF	GLCTLVAML	1
CASSPAFSRHYEQYF	LPRRSGAAGA	1
CASSLQGMGQPQHF	ELAGIGILTV	1
CASSLRSNTEAFF	GILGFVFTL	1
CATSDSYEQYF	IIKDYGKQM	1
CASSLTDPYEQHF	GLCTLVAML	1
CARDTIGNGYTF	GLCTLVAML	1
CASRPQGLGQPQHF	EAAGIGILTV	1
CASSLTGGNTEAFF	LPRRSGAAGA	1
CASSEDKGGGDTQYF	IIKDYGKQM	1
CASSQRTGSSYEQYF	LPRRSGAAGA	1
CASSVDKGGTDTQYF	IIKDYGKQM	1
CASSIRASYEQYF	GILGFVFTL	1
CASSPGTPRDEQFF	CRVLCCYVL	1
CASSMRSTDTQYF	GILGFVFTL	1
CASSLAQGYEQYF	LPRRSGAAGA	1
CASSSRARGNQPQHF	RFYKTLRAEQASQ	1
CASQRGARGGNQPQHF	RFYKTLRAEQASQ	1
CANSLYTGSDQPQHF	FPRPWLHGL	1
CASSWGNTGELFF	FLCMKALLL	1
CASSSRSTDTQYF	GILGFVFTL	1
CASSMAGSSYEQYF	GMGPLLAMV	1
CASSPRDGQETQYF	GILGFVFTL	1
CASSPPSGPVRNEQFF	LPRRSGAAGA	1
CSAYETSWNEQFF	LPRRSGAAGA	1
CASSALASGGDEQFF	RFYKTLRAEQASQ	1
CASSLGTSYEQYF	GILGFVFTL	1
CASSLASDRAQETQYF	RPHERNGFTVL	1
CASSEAGGTEAF	EIYKRWII	1
CASSWGPGYEQYF	VVLSWAPPV	1
CSARDSTGNGYTF	GLCTLVAML	1
CASSVGEGTEAFF	NLNCCSVPV	1
CASSIRTDTQYF	PQPQLPYPQPQ	1
CASSSGTGAYEQYF	HIAKSPFEV	1
CASTLTGLGQPQHF	ELAGIGILTV	1
CASSVVGSYNEQFF	RFYKTLRAEQASQ	1
CASSFGATDTQYF	GLCTLVAML	1
CASSVGVSYEQYF	LPRRSGAAGA	1
CASSTRTTDTQYF	PQPELPYPQPQ	1
CASSQSPGGFQYF	GLCTLVAML	1
CASSQEGGGDGQPQHF	TPQDLNTML	1
CASSMRAGYEQYF	GILGFVFTL	1
CASSPRTSGSYEQYF	RFYKTLRAEQASQ	1
CASSPDRAPEAFF	SFHSLHLLF	1
CASSIRSTDTQYF	PQPELPYPQPQ	1
CASSLSGNEQYF	GLCTLVAML	1
CASSQGVNTGELFF	LPRRSGAAGA	1
CASSDRTSGINEQFF	GILGFVFTL	1
CSTRGQAITEKLFF	GLCTLVAML	1
CASSQGQLGNTIYF	KRWIILGLNK	1
CASSLSDTQYF	GILGFVFTL	1
CASSIRATDTQYF	PQPELPYPQPE	1
CASSPTSSTTSYEQHF	GLCTLVAML	1
CASSQSPGGTQYF	GLCTLVAML	1
CASSQDRGQVYGYTF	SFHSLHLLF	1
CASSPTGQAHEQYF	FWIDLFETIG	1
CAISERAIRGTSGLTDTQYF	TQGYFPDWQNY	1
CASSLSHSTGNYGYTF	TPRVTGGGAM	1
CASQLYSGGDQPQHF	FPRPWLHGL	1
CASSIRSSVEQFF	GILGFVFTL	1
CASSLAVDEQYF	CRVLCCYVL	1
CASSLSWGGFYNEQLF	TPRVTGGGAM	1
CASSLMGRGPNTGGLFF	GLCTLVAML	1
CASSQGQLGNTLYF	KRWIILGLNK	1
CASSSGSYGYTF	GILGFVFTL	1
CSVGAGGTNEKLFF	GLCTLVAML	1
CASSQDRGNEQFF	FLIYLDVSV	1
CASSLVVPQLPTYEQFF	VTEHDTLLY	1
CASSIRPSYEQYF	GILGFVFTL	1
CASSQGASDTQYF	GLCTLVAML	1
CASSSGTINTGELF	ATDALMTGY	1
CASSLRSTDTQYF	GILGFVFTL	1
CASSQAQREWDEQFF	LPRRSGAAGA	1
CASSTGLTEAFF	LPRRSGAAGA	1
CAWSRGAAEQFF	GLCTLVAML	1
CASSIQGNSNQPQHF	RLGPYLEFL	1
CASTPGDEQFF	CRVLCCYVL	1
CASSLGVNTIYF	TPQDLNTML	1
CASSLRSSYEQYF	FQAQHIAMA	1
CASSFITDTQYF	VTEHDTLLY	1
CVSSQGLASYEQYF	LPRRSGAAGA	1
CASSFRSTDTQYF	PQPELPYPQPQ	1
CASSTKDGGTGELFF	GILGFVFTL	1
CASSLTDPYEQNF	GLCTLVAML	1
CASGLVPEGLVYEQYF	GILGFVFTL	1
CASSSGQKNEKLFF	CRVLCCYVL	1
CSATSRQGGREQYF	HPKVSSEVHI	1
CASSPRTSGTYEQYF	RFYKTLRAEQASQ	1
CSVGQFSSYEQFF	LPRRSGAAGA	1
CASSLGPGQRETQYF	QVELGGGPG	1
CASSLINTEAFF	LPRRSGAAGA	1
CASSLSPSTGNYGYTF	TPRVTGGGAM	1
CASSWAGGPRDEQYF	NLVPMVATV	1
CASSFTGNTEAFF	LPRRSGAAGA	1
CASSTRAADTQYF	GILGFVFTL	1
CASSLVLQETQYF	GLCTLVAML	1
CASTPGDEQYF	CRVLCCYVL	1
CASSARTSGGTDTQYF	RFYKTLRAEQASQ	1
CASSLRAGGSHEQYF	PQPELPYPQPQ	1
CASSSRSGVEQYF	GILGFVFTL	1
CASSKGDTEAFF	LPRRSGAAGA	1
CASSLAQGAETQYF	FWIDLFETIG	1
CASSNRQGGTGELF	HSKKKCDEL	1
CASSLTSGNEQFF	FRCPRRFCF	1
CASSASGGSYNEQFF	LPRRSGAAGA	1
CASSLRTEVYNEQFF	CRVLCCYVL	1
CASSLVIYNEQFF	LPRRSGAAGA	1
CASSLGANTIYF	TPQDLNTML	1
CASSIRGSYEQYF	GILGFVFTL	1
CASSLIGRGPNTGELFF	GLCTLVAML	1
CASTYRDSGNTIYF	KLPLDIDPV	1
CASSLFSNQPQHF	FRCPRRFCF	1
CASSPDSDAYEQYF	GILGFVFTL	1
CASSDRGSTDTQYF	LPRRSGAAGA	1
CASSTATPNTEAFF	CRVLCCYVL	1
CASSLDSYEQYF	KRWIILGLNK	1
CASSSAYYGYTF	NLVPMVATV	1
CASSLRSGGLNYGYTF	GLCTLVAML	1
CASSFGVGQPQHF	LMFWASSSI	1
CASSHSRGSGNTIYF	HSKKKCDEL	1
CASSLASGNEQFF	KLPLDINPV	1
CASSPKGGRTGELFF	LPRRSGAAGA	1
CASSWSAGGPYEQYF	LPRRSGAAGA	1
CASSFGTGGYEQYF	IAMAVLYLA	1
CASSLAGTYEQYF	LPRRSGAAGA	1
CASSQDLGEQYF	LPRRSGAAGA	1
CASSELTSGGDEQLF	RFYKTLRAEQASQ	1
CPSSPRGGGETQYF	TPGPGVRYPL	1
CASSQDLSSGNTIYF	FRCPRRFCF	1
CASSLSGSYEQYF	LPRRSGAAGA	1
CASSPDRAHTQYF	SFHSLHLLF	1
CSVGSGGTNEKLFF	GLCTLVAML	1
CASSQSGTEAFF	LPRRSGAAGA	1
CASSYRSSYEQYF	GILGFVFTL	1
CASSSRGTYEQYF	GLCTLVAML	1
CASSLMASGGYNEQF	RAKFKQLL	1
CASSGRSAETQYF	GILGFVFTL	1
CASSIRAAYEQYF	GILGFVFTL	1
CASSGQGGYEQYF	LLWNGPMAV	1
CASSLEGYTEAFF	NLVPMVATV	1
CASSLSGSTDTQYF	LPRRSGAAGA	1
CASSARTSGGADTHYF	RFYKTLRAEQASQ	1
CASSLGSMQETQYF	GILGFVFTL	1
CASSDAASGVGEQYF	RFYKTLRAEQASQ	1
CASSDSYEQYF	LLWNGPMAV	1
CASSPLVRGRFSNQPQHF	GLCTLVAML	1
CSVTSERTGTNWGYTF	RAKFKQLL	1
CASSLQGLGQPQHF	EAAGIGILTV	1
CASSLGFSGANVLTF	FRCPRRFCF	1
CSARGQAITDKLFF	GLCTLVAML	1
CASSGDTDTQYF	LPRRSGAAGA	1
CASSPRQGIETQYF	GILGFVFTL	1
CASSVVGGNEQFF	GLCTLVAML	1
CASSLGGYEQYF	LPRRSGAAGA	1
CASSARTSGSDEQYF	RFYKTLRAEQASQ	1
CASSTFGATQEIQYF	TPGPGVRYPL	1
CASSQSPGGTQNF	GLCTLVAML	1
CASSPMASGGDEQFF	RFYKTLRAEQASQ	1
CASRQGRGDTEAFF	LPRRSGAAGA	1
CASSIHGADTQYF	GILGFVFTL	1
CASTGTAYGYTF	KAFSPEVIPMF	1
CASSPPSGSAYNEQFF	LPRRSGAAGA	1
CASSQQGLGTEAF	ELAGIGILTV	1
CSVEDFYNEQFF	GLCTLVAML	1
CASSLNPRQGRDEQYF	LPRRSGAAGA	1
CASSQAGGYEQYF	NLNCCSVPV	1
CASSLEEAGKMNTEAFF	FRCPRRFCF	1
CASSLAESVYEQFF	GILGFVFTL	1
CASSETGFGNQPQHF	NLVPMVATV	1
CSARDRKGNGYTF	GLCTLVAML	1
CSVEGRGYEQYF	LPRRSGAAGA	1
CASSSTYEQFF	LPRRSGAAGA	1
CASSSSNNEQFF	LPRRSGAAGA	1
CASRPTGQLETQYF	ATDALMTGY	1
CASSSGNNEQFF	GLCTLVAML	1
CASSSRSSYEQYF	GILGFVFTL	1
CASSWSGGGARDTQNF	VTEHDTLLY	1
CASSTRSTYEQYF	GILGFVFTL	1
CVSSVDKGGTDTQYF	IIKDYGKQM	1
CASSIGYFGYTF	GILGFVFTL	1
CANSLSGDYGYTF	GLCTLVAML	1
CASSPNGQAHEQYF	FWIDLFETIG	1
CASSLDSYNEQFF	LPRRSGAAGA	1
CASSLSGPYNEQFF	LPRRSGAAGA	1
CSAADTGLGQPQHF	EAAGIGILTV	1
CSARDTVGNGYTF	GLCTLVAML	1
CASSLAPGATSEKLF	NLVPMVATV	1
CASSLRASGSHEQYF	PQPELPYPQPE	1
CASSLRFTDTQYF	PQPQLPYPQPQ	1
CASSLMGRGPKTGELFF	GLCTLVAML	1
CASSLTNPYEQYF	GLCTLVAML	1
CASSVQGLGQPQHF	ELAGIGILTV	1
CASTLAGGPYEQYF	NLNCCSVPV	1
CASSQTVMNTEAFF	RPHERNGFTVL	1
CASSFSGTAYGYTF	LPRRSGAAGA	1
CATSRDAGETQYF	FRCPRRFCF	1
CASSTGNYGYTF	KLVALGINAV	1
CASSFRVSDTQYF	PQPELPYPQPQ	1
CASSVAELAGGTDTQYF	GLCTLVAML	1
CASSPGTGAYEQYF	LLWNGPMAV	1
CASSLSVYEQYF	LPRRSGAAGA	1
CASSYSAGGPYEQYF	VTEHDTLLY	1
CASSLTDPHEQYF	GLCTLVAML	1
CASSLALAGTDTQYF	GILGFVFTL	1
CSVGAAGTNEKLF	GLCTLVAML	1
CASSQSPGGKQYF	GLCTLVAML	1
CASSLSKNTEAF	TPQDLNTML	1
CASSQGHGPFNQPQRF	GLCTLVAML	1
CASSKRTSGTYEQYF	RFYKTLRAEQASQ	1
CASRTSGEETQYF	IIKDYGKQM	1
CASSPISNEQFF	CRVLCCYVL	1
CASSAATPNTEAFF	CRVLCCYVL	1
CAWSRVGGYEQFF	GILGFVFTL	1
CASSPTGDNTGELFF	NLVPMVATV	1
CASSSAITGMGDSGNTIYF	TPQDLNTML	1
CSAPDTGLGQPQHF	EAAGIGILTV	1
CASRWGLGGELFF	CRVLCCYVL	1
CASSEGARGVGEQFF	RFYKTLRAEQASQ	1
CASSVPGTPNTEAFF	LLSIISFPA	1
CASQPGQKNTEAFF	CRVLCCYVL	1
CASSQDFRGGYEQHF	GLCTLVAML	1
CASSQSPGGAQYF	GLCTLVAML	1
CASSVQGYTEAF	NLVPMVATV	1
CASSWPGGGARDTQHF	VTEHDTLLY	1
CASSSGQKNTEAFF	CRVLCCYVL	1
CASSLASEQYF	KLSREIMPV	1
CASSFGGLGTEAF	EAAGIGILTV	1
CASSIQGALTDTQYF	LMFWASSSI	1
CASSGRSAGELFF	GILGFVFTL	1
CASSQDPNTDATNEKLFF	FRCPRRFCF	1
CASSSPGENYNEQFF	GILGFVFTL	1
CASSELASGINEQFF	RFYKTLRAEQASQ	1
CASSQEGTGSYEQYF	AVFDRKSDAK	1
CASSLLGSGETQYF	LPRRSGAAGA	1
CASSFGGSSYEQYF	VVLSWAPPV	1
CASSVDKGGTDEQF	IIKDYGKQM	1
CASSQSPGGTQHF	GLCTLVAML	1
CASSAWDNEQFF	CRVLCCYVL	1
CASSLTTPPSTDPQYF	ELAGIGILTV	1
CASSFITDTQYF	LPRRSGAAGA	1
CSVEAGGSIYNEQF	GLCTLVAML	1
CASSLLGDGETQYF	ENPVVHFFKNIVTPR	1
CASSLIGEETTEDEQFF	LPRRSGAAGA	1
CASSLGGDEQYF	NLFNRYPAL	1
CASSYQTGPYSNQPQHF	MMPFSIVYI	1
CASSRTGMGETQYF	GLCTLVAML	1
CASSVWAGGYNEQFF	VVMSWAPPV	1
CASSLGDAQETQYF	LPRRSGAAGA	1
CASSAGTGAYEQYF	LLWNGPMAV	1
CASRPRRAGGDRELLF	GLCTLVAML	1
CASSELAAGTDTQYF	RFYKTLRAEQASQ	1
CASSQDPGTDATNEKLFF	FRCPRRFCF	1
CASSLTDTQYF	VTEHDTLLY	1
CASTITGAGTDTQYF	LPRRSGAAGA	1
CASSPSRNTEAFF	TPRVTGGGAM	1
CASSSLGGAGTGELF	NLVPMVATV	1
CASSIRSTNEQFF	GILGFVFTL	1
CASREYATSNEQYF	RFYKTLRAEQASQ	1
CGARDGTGNGYTF	GLCTLVAML	1
CSARGQAITENLFF	GLCTLVAML	1
CASSVRSTDTQYF	GILGFVFTL	1
CASSLSWGGFYNEQFF	TPRVTGGGAM	1
CSARGQAITEQLFF	GLCTLVAML	1
CASSVQGLGQPQHF	EAAGIGILTV	1
CSVVGQGHEQFF	LPRRSGAAGA	1
CASSYQTGAAYGYTF	NLVPMVATV	1
CASSFGGTEAFF	LPRRSGAAGA	1
CSARDGKGNGYTF	GLCTLVAML	1
CASQGDTDTQYF	LPRRSGAAGA	1
CASSLWGGGFSQEQF	FPRPWLHGL	1
CASSPGTAYEQYF	KLWASPLHV	1
CSVDRGRTDTQYF	LPRRSGAAGA	1
CASSFGGMGQPQHF	EAAGIGILTV	1
CAWSRGAVEQVF	GLCTLVAML	1
CASSPYSGANVLTF	YMFLASPSV	1
CASSIRSSQPQHF	GILGFVFTL	1
CASSWGNTGELFF	IMNDMPIYM	1
CASSFGANTGELFF	FLTYLDVSV	1
CASSSGRDSGANVLTF	GLCTLVAML	1
CASTPGTGAYEQYF	LLWNGPMAV	1
CASSIRSSYEQYF	GILGFVFTL	1
CASSLAYEQYF	AVGSHVYSV	1
CASMNDGATYEQYF	NLVPMVATV	1
CASSIRAADTQYF	GILGFVFTL	1
CASSYGLAGEEEYF	CRVLCCYVL	1
CASSLHDRGFRTEAFF	TPRVTGGGAM	1
CASSMRSAGELFF	GILGFVFTL	1
CARDGTGNGYTF	GLCTLVAML	1
CASSQDRGYVYGYTF	SFHSLHLLF	1
CASSSRSGYEQYF	GILGFVFTL	1
CSVGRDGTNEKLFF	GLCTLVAML	1
CASSLLQGPSYEQFF	GILGFVFTL	1
CASSFGQGGYEQYF	GILGFVFTL	1
CASTGSGYGYTF	KAFSPEVIPMF	1
CASSVGGVSYNEQFF	LLWNGPMAV	1
CASSSAQPNTEAFF	CRVLCCYVL	1
CSVGSGGTNERLF	GLCTLVAML	1
CSYAAGVNEQFF	GLCTLVAML	1
CASSYGLEQFF	GILGFVFTL	1
CASSIRSTYEQYF	GILGFVFTL	1
CATSSASGSGSDTQYF	GLCTLVAML	1
CASSFGPGYEQYF	VVMSWAPPV	1
CASSFPNQPQHF	LLWNGPMAV	1
CASSQESGGGYEQFF	LPRRSGAAGA	1
CSVEDFYNEQSF	GLCTLVAML	1
CASSLSGLAGQETQYF	CRVLCCYVL	1
CSVTGERGTDTQYF	LLWNGPMAV	1
CASSFGDTQYF	CRVLCCYVL	1
CASSPRGGGETQHF	TPGPGVRYPL	1
CASSATGGSYNEQFF	LPRRSGAAGA	1
CAWTLAGRDNGELFF	GLCTLVAML	1
CASSARTSGGLDEQYF	RFYKTLRAEQASQ	1
CASSRLASGTDTQYF	RFYKTLRAEQASQ	1
CASSPTGGLETQYF	GILGFVFTL	1
CASSLGVNQPQHF	LPRRSGAAGA	1
CSASGDRGADTQYF	LLWNGPMAV	1
CASSPGRNTEAFF	RPHERNGFTVL	1
CASSSANYGYTF	NLVPMVATV	1
CSARGQTITEKLFF	GLCTLVAML	1
CASSIGDTSYEQYF	GILGFVFTL	1
CSAREGTGNGYTF	GLCTLVAML	1
CASSFGGLGQPQHF	EAAGIGILTV	1
CASSRGTGGYEQFF	MLNIPSINV	1
CASNPTGGLETQYF	CRVLCCYVL	1
CASSVRTSGSYEQYF	RFYKTLRAEQASQ	1
CASSLGPTVPGNTIYF	HPKVSSEVHI	1
CASSQLAVSYNEQFF	GLCTLVAML	1
CASSIGVYGYTF	GILGFVFTL	1
CASSDSQNEQYF	GLCTLVAML	1
CAWSVAGSTDTQYF	GILGFVFTL	1
CASSLEAGGQPQHF	VTEHDTLLY	1
CASSARTSAGTDTQYF	RFYKTLRAEQASQ	1
CASSEGRVSPGELF	GLCTLVAML	1
CASTPSGTASYEQYF	EAAGIGILTV	1
CASSIRSQVEQFF	GILGFVFTL	1
CASSMRSSYEQYF	GILGFVFTL	1
CASSMRSGETQYF	GILGFVFTL	1
CASSIRSGHEQFF	GILGFVFTL	1
CASSYGGGYEQYF	NLNCCSVPV	1
CASSIGAHGYTF	GILGFVFTL	1
CASSLSGSSYEQYF	LLWNGPMAV	1
CASSRLAGGTDTQYF	RFYKTLRAEQASQ	1
CASSSVSGGAFNEQYF	GILGFVFTL	1
CASSPEGVSYEQYF	GILGFVFTL	1
CASSGSYEQYF	LPRRSGAAGA	1
CASSYGLAGQETQYF	LPRRSGAAGA	1
CASSLTSATGELF	AVFDRKSDAK	1
CASSPRQGTETQYF	GLCTLVAML	1
CASSFGQGYEQYF	NLNCCSVPV	1
CASSQGGYGYTF	LLWNGPMAV	1
CASSTSLGGGARQYF	GILGFVFTL	1
CRVDGFRTENNQPQHF	GLCTLVAML	1
CASSSGQRNSPLHF	CRVLCCYVL	1
CRARGQAITEKLFF	GLCTLVAML	1
CASSSGTVSYEQYF	LPRRSGAAGA	1
CASSLAGGPYEQYF	LPRRSGAAGA	1
CASSPSRNTEAFF	RPHERNGFTVL	1
CASSVDKGGVDEQF	IIKDYGKQM	1
CANSSFLSSGETQYF	KAFSPEVIPMF	1
CASSYGQGTGELF	GILGFVFTL	1
CASSQGLAGTGELFF	RFYKTLRAEQASQ	1
CASSPTGGSSYEQYF	LPRRSGAAGA	1
CASSLTGLNEQYF	LPRRSGAAGA	1
CASSWFGGGARDTQYF	VTEHDTLLY	1
CASSSTGGGGAEAF	QYDPVAALF	1
CSVQEGGYGYTF	GLCTLVAML	1
CASSLTSGNEQFF	GILGFVFTL	1
CASSFGGYEQYF	KLVALGINAV	1
CSAPDWNNEQFF	CRVLCCYVL	1
CASSIRSMDIQYF	GILGFVFTL	1
CSATGGSYEQYF	LPRRSGAAGA	1
CASSFQGLGQPQHF	EAAGIGILTV	1
CASSTSLLAGNNEQF	NLVPMVATV	1
CASSLSYEQYF	LPRRSGAAGA	1
