cdr3	peptide	Binding
CASSYLPGQGDHYSNQPQHF	FLKEKGGL	1
CASSFEAGQGFFSNQPQHF	FLKEKGGL	1
CASSFEPGQGFYSNQPQHF	FLKEKGGL	1
CASSYEPGQVSHYSNQPQHF	FLKEKGGL	1
CASSALASLNEQFF	FLKEKGGL	1
CASSYLPGQGDHYSNQPQHF	FLKEQGGL	1
CASSFEAGQGFFSNQPQHF	FLKEQGGL	1
CASSFEPGQGFYSNQPQHF	FLKEQGGL	1
CASSYEPGQVSHYSNQPQHF	FLKEQGGL	1
CASSYLPGQGDHYSNQPQHF	FLKETGGL	1
CASSFEAGQGFFSNQPQHF	FLKETGGL	1
CASSFEPGQGFYSNQPQHF	FLKETGGL	1
CASSYEPGQVSHYSNQPQHF	FLKETGGL	1
CASSYLPGQGDHYSNQPQHF	FLKEMGGL	1
CASSFEAGQGFFSNQPQHF	FLKEMGGL	1
CASSFEPGQGFYSNQPQHF	FLKEMGGL	1
CASSYEPGQVSHYSNQPQHF	FLKEMGGL	1
CASSQTTKDEQYF	KTFPPTEPK	1
CASSQGQKDEQYF	KTFPPTEPK	1
CASSQFTGRKEKLFF	KTFPPTEPK	1
CASSLTSGGPTSDTQYF	LLYDANYFL	1
CASTTPVTERYNEQFF	LLYDANYFL	1
CASTTSRGAISTDTQYF	LLYDANYFL	1
CASSQGTGGANEQYF	LLYDANYFL	1
CASSLAGSTEAFF	LLYDANYFL	1
CASSLTSGGPVTDTQYF	LLYDANYFL	1
CASSLGGTEAFF	LLYDANYFL	1
CASSLGGSTEAFF	LLYDANYFL	1
CASSEKARGNEQFF	KTFPPTEPK	1
CATDRNTEAFF	KTFPPTEPK	1
CASSPRQGDTQYF	KTFPPTEPK	1
CSARGSSGRAEYTQYF	ALSKGVHFV	1
CASSQGQGLAGIGETQYF	ALSKGVHFV	1
CASSLVGGPLSYEQYF	ALSKGVHFV	1
CASSLVGDSYNEQFF	ALSKGVHFV	1
CASSLSGDDYNEQFF	ALSKGVHFV	1
CASSPGAGAEETQYF	ALSKGVHFV	1
CSAPILSPYEQYF	LLLDRLNQL	1
CASSASNYGYTF	LLLDRLNQL	1
CASSAELNTYEQYF	LLLDRLNQL	1
CASSIPTSSYEQYF	LLLDRLNQL	1
CATEAGTGTNYGYTF	LLLDRLNQL	1
CASTETSGAYNEQFF	LLLDRLNQL	1
CASSVEGASYEQYF	LLLDRLNQL	1
CASSEGGGEQYF	LLLDRLNQL	1
CASSSGTVPYEQYF	LLLDRLNQL	1
CASASAAYEQYF	LLLDRLNQL	1
CASGGNSYEQYF	LLLDRLNQL	1
CASSPDSVEQYF	LLLDRLNQL	1
CASSVELNSYEQYF	LLLDRLNQL	1
CASSVAHLNTDTQYF	LLLDRLNQL	1
CASSQDRGFGAEAEAFF	ALSKGVHFV	1
CASSEVAGDTQYF	ALSKGVHFV	1
CASSLAGDSYNEQFF	ALSKGVHFV	1
CASSAEGSPEAFF	ALSKGVHFV	1
CASSPQGSGTGPNQPQHF	ALSKGVHFV	1
CATSGNSWTGDVGTEAFF	ALWEIQQVV	1
CASTGTGVFNEQFF	ALWEIQQVV	1
CASSQDPGTSVYNEQFF	ALWEIQQVV	1
CASSYGLERQFF	ALWEIQQVV	1
CATSRDLGLYNEQFF	RLQSLQTYV	1
CASSQDLQGPDEKLFF	RLQSLQTYV	1
CASSQDLQGTNEKLFF	RLQSLQTYV	1
CASSYSGGNTEAFF	RLQSLQTYV	1
CAWSLGNSIELNYGYTF	RLQSLQTYV	1
CASSLGGAEAFF	LLYDANYFL	1
CASSLGSGGTEAFF	LLYDANYFL	1
CASSLEAGGREQYF	LLYDANYFL	1
CSADPVAGGGYEQYF	ALSKGVHFV	1
CASSEVGNEQFF	ALSKGVHFV	1
CASNGLAGVSYNEQFF	ALSKGVHFV	1
CASSSGVERPYEQYF	ALSKGVHFV	1
CASSLAGDDYNEQFF	ALSKGVHFV	1
CASSYLLAMNTGELFF	ALSKGVHFV	1
CASSTKGPNNEQFF	KTFPPTEPK	1
CASSVLSGGPFNEQFF	KTFPPTEPK	1
CASSLPSGQGAYNEQFF	KTFPPTEPK	1
CASSLAKKDTQYF	KTFPPTEPK	1
CASSPQGLGTEAFF	ELAGIGILTV	1
CASSPGQLGNTIYF	KRWIILGLNK	1
CASRLLGGGQETQYF	KRWIILGLNK	1
CASSPGVFGVTQYF	KRWIILGLNK	1
CASSQGVSSTEAFF	KRWIILGLNK	1
CSARDLGLAGDTDTQYF	KRWIILGLNK	1
CASSLDSYEQYF	KRWIILGLNK	1
CASSPLGGHHSGANVLTF	KRWIILGLNK	1
CASSLDVNEQFF	KRWIILGLNK	1
CASSTGTVYNEQFF	KRWIILGLNK	1
CASSYDLNEQYF	KRWIILGLNK	1
CSARVTSSDEQYF	KRWIILGLNK	1
CASSYDNYEQYF	KRWIILGLNK	1
CASSSDREEQYF	KRWIILGLNK	1
CSARQGLNNEQFF	KRWIILGLNK	1
CASSPLGDRETQYF	KRWIILGLNK	1
CASSFIAGTEAFF	KRWIILGLNK	1
CASSLVAGTYNEQFF	KRWIILGLNK	1
CSASDNELPGSSYNEQFF	KRWIILGLNK	1
CASSMADLSYEQYF	KRWIILGLNK	1
CASSGGLPEGYTF	KRWIILGLNK	1
CSASNPLLGQGAGYGYTF	KRWIILGLNK	1
CSGRGVAYNSPLHF	KRWIILGLNK	1
CASSQDITFPKQFF	KRWIILGLNK	1
CSVPGLAQNEQFF	KRWIILGLNK	1
CASSPGTGELFF	KRWIILGLNK	1
CASSQGQYSHEQYF	KRWIILGLNK	1
CASSQGRLSAEAFF	KRWIILGLNK	1
CASSPGRLGNEQYF	KRWIILGLNK	1
CASSPGWGSYEQYF	RLRPGGKKK	1
CASSPQRGFYEQYF	RLRPGGKKK	1
CASSSDRSFYGYTF	RLRPGGKKK	1
CASSLDRGVGGYTF	RLRPGGKKK	1
CASSPGWGNTEAFF	RLRPGGKKK	1
CASSHGLAGVGETQYF	RLRPGGKKK	1
CASSLWGERLNTEAFF	RLRPGGKKK	1
CASSLGWGPNEQFF	RLRPGGKKK	1
CASATIMGGRASNEQFF	RLRPGGKKK	1
CASSQETGDEQYF	GPGMKARVL	1
CASSLELGDEQFF	GPGMKARVL	1
CASSQETGDTQYF	GPGMKARVL	1
CASSLETGDEQYF	GPGMKARVL	1
CASSFDAEQFF	SLYNTVATL	1
CASSLIGHSNQPQHF	SLYNTVATL	1
CSAPVLPQETQYF	SLYNTVATL	1
CASSFDSEAFF	SLYNTVATL	1
CATSFDSEAFF	SLYNTVATL	1
CASSFDAEAFF	SLYNTVATL	1
CASTPVGHSNQPQHF	SLYNTVATL	1
CASNLGGPQQPQHF	SLYNTVATL	1
CASSAYRGQANEQFF	QVPLRPMTYK	1
CASSYSRGVGNTIYF	QVPLRPMTYK	1
CAISDFDRAGTQYF	QVPLRPMTYK	1
CASYPDRGRVNEQFF	QVPLRPMTYK	1
CSARVRAGSYNEQFF	QVPLRPMTYK	1
CASSLYTSNNEQFF	QVPLRPMTYK	1
CSARDVVDGNTGELFF	FLKEKGGL	1
CASSFLPGQGSYYSNQPQHF	FLKEKGGL	1
CASSSFGPSNQPQHF	KRWIILGLNK	1
CASSRQSGEREQFF	KRWIILGLNK	1
CASSEDRNEQFF	KRWIILGLNK	1
CASRPGQGNNEQFF	KRWIILGLNK	1
CASGEGTLSYEQYF	KRWIILGLNK	1
CASSFGTGGEQYF	KRWIIMGLNK	1
CASSGGRDRSHEQYF	KRWIIMGLNK	1
CASSYPGQGVGGYTF	KRWIIMGLNK	1
CASSSFGPSNQPQHF	KRWIIMGLNK	1
CASSYQTGAAYGYTF	NLVPMVATV	1
CASRSAQRGFTETQYF	NLVPMVATV	1
CASSPVTGQGFYGYTF	NLVPMVATV	1
CASSEEPSGGAYEQYF	NLVPMVATV	1
CASRALAGGQVEQFF	NLVPMVATV	1
CATSREGPNQPQHF	NLVPMVATV	1
CSAKILAGAGSEQYF	NLVPMVATV	1
CASSLAASVNPAYGQYF	NLVPMVATV	1
CASSLSAGQGMTDTQYF	KRWIILGLNK	1
CSVEGEEDANYEQYF	KRWIILGLNK	1
CASSQAREQFF	KRWIILGLNK	1
CASSFGGAGDTEAFF	KRWIILGLNK	1
CAISHTGELFF	KRWIILGLNK	1
CASSRDTVYNQPQHF	KRWIILGLNK	1
CASSPGTSIDEQFF	KRWIILGLNK	1
CASSPGAGENIQYF	KRWIILGLNK	1
CASSQVWGSGEKLFF	NLVPMVATV	1
CASSLAPGATNEKLFF	NLVPMVATV	1
CASRGLAGGLGELFF	NLVPMVATV	1
CASSIGGTGGIPQHF	NLVPMVATV	1
CASSLRGGNTDTQYF	KRWIILGLNK	1
CASSQSTGELFF	KRWIILGLNK	1
CASSQGIFAYEQYF	KRWIILGLNK	1
CASSGNSFSAFF	KRWIILGLNK	1
CATSETGELFF	KRWIILGLNK	1
CASSPGQFGNTIYF	KRWIILGLNK	1
CASSLRGGNTDTQYF	KRWIIMGLNK	1
CASSQGIFAYEQYF	KRWIIMGLNK	1
CAWSLTGMNQPQHF	KRWIIMGLNK	1
CSARAGLNNEQFF	KRWIIMGLNK	1
CASSSANYGYTF	NLVPMVATV	1
CASSFQGYTEAFF	NLVPMVATV	1
CATSSSWDLNQPQHF	NLVPMVATV	1
CASSYGGGEDYGYTF	NLVPMVATV	1
CASSLEGYTEAFF	NLVPMVATV	1
CASSPHQADTQYF	NLVPMVATV	1
CASSLLGGNPTQYF	KRWIILGLNK	1
CASRPGQGSHEQYF	KRWIILGLNK	1
CASSLLGGNPTQYF	KRWIIMGLNK	1
CASSTPGGGQDTQYF	KRWIIMGLNK	1
CASSLGTSSYEQYF	KRWIILGLNK	1
CANSLGTSSYEQYF	KRWIILGLNK	1
CASTEYSGSIEQFF	KRWIILGLNK	1
CASSRKTGPYEQYF	KRWIILGLNK	1
CASSLGTSSYEQYF	KRWIIMGLNK	1
CASSFTTLGEQYF	KRWIIMGLNK	1
CASSLYGEQYF	KRWIIMGLNK	1
CASAPGLMSYEQYF	KRWIIMGLNK	1
CASSLTSGSPYNEQFF	NLVPMVATV	1
CASSPVAGAPHEQYF	NLVPMVATV	1
CASMGGANTEAFF	KRWIILGLNK	1
CASSLVGRGLDEQYF	KRWIIMGLNK	1
CASSLLGGGGEAFF	KRWIIMGLNK	1
CASSFSSLGEQFF	KRWIIMGLNK	1
CSAPLAGAPQDTQYF	KRWIILGLNK	1
CASRPGQGSHEQFF	KRWIILGLNK	1
CASSFGPSNQPQHF	KRWIILGLNK	1
CASSLLEHNNGELFF	KRWIIMGLNK	1
CASRPGQGSHEQFF	KRWIIMGLNK	1
CASSKQSGTGYYGYTF	NLVPMVATV	1
CASSQLGPSAYEQYF	NLVPMVATV	1
CSARDQRGLAGGIGDTQYF	NLVPMVATV	1
CASSLQTGAGGFGYTF	NLVPMVATV	1
CASSAVAGAPLEQYF	NLVPMVATV	1
CASSPGQFSHEAFF	KRWIILGLNK	1
CASRTGQGAYEQYF	KRWIILGLNK	1
CASSRGTSDYEQYF	KRWIILGLNK	1
CASSPGQFSHEAFF	KRWIIMGLNK	1
CASSRGTSDYEQYF	KRWIIMGLNK	1
CASRTGQGAYEQYF	KRWIIMGLNK	1
CASSLGVDFNYGYTF	YSEHPTFTSQY	1
CSVTGTSYEQYF	YSEHPTFTSQY	1
CATSSPGLASDEQFF	YSEHPTFTSQY	1
CASSFNGPNTEAFF	ELRRKMMYM	1
CAISEFGLAGSDEQFF	ELRRKMMYM	1
CASSLFDGTGSTEAFF	ELRRKMMYM	1
CASSPTPGQRNGYTF	QIKVRVDMV	1
CASSLKPGLSIDTQYF	QIKVRVDMV	1
CATSVPSGRSYNEQFF	QIKVRVDMV	1
CASSRAGAYNEQFF	QIKVRVDMV	1
CASNRESAYTF	HPVGEADYFEY	1
CASREKGYDEQFF	HPVGEADYFEY	1
CATSGRYGEQFF	HPVGEADYFEY	1
CAISTGDSNQPQHF	EPLPQGQLTAY	1
CASSTGDHSNQPQHF	EPLPQGQLTAY	1
CATGTGDSNQPQHF	EPLPQGQLTAY	1
CASSHTGAEAFF	IPSINVHHY	1
CASSPTTAYEQYF	IPSINVHHY	1
CASSPALDAQYF	IPSINVHHY	1
CASSPDLGSTEAFF	IPSINVHHY	1
CASSLDLGSTEAFF	IPSINVHHY	1
CASRPGLAGGRPEQYF	LLFGYPVYV	1
CASSYPGGGFYEQYF	LLFGYPVYV	1
CASSLGQAYEQYF	FLRGRAYGL	1
CASSSRSSYEQYF	GILGFVFTL	1
CASRPGLAGGRPEQYF	LLFGYAVYV	1
CASRPGLAGGRPEQYF	LLFGYPRYV	1
CASRPGLAGGRPEQYF	LLFGYPVAV	1
CASPGLAGEYEQYF	LPEPLPQGQLTAY	1
CASSYVGNTGELFF	SLLMWITQV	1
CASSYVGNTGELFF	SLLMWITQC	1
CASSQDRDTQYF	VMAPRTLIL	1
CASRPGLAGGRPEQYF	LLFGKPVYV	1
CASSYLGNTGELFF	SLLMWITQC	1
CASSSRASYEQYF	GILGFVFTL	1
CASTGSYGYTF	KAFSPEVIPMF	1
CASRPGLAGGRPEQYF	LLFGPVYV	1
CASRYRDDSYNEQFF	EENLLDFVRF	1
CASSFTWTSGGATDTQYF	FLRGRAYGL	1
CASSPVTGGIYGYTF	NLVPMVATV	1
CASRPGLAGGRPEQYF	MLWGYLQYV	1
CAWSETGLGTGELFF	ELAGIGILTV	1
CASSLGQAYEQYF	EEYLKAWTF	1
CASSLGQAYEQYF	EEYLQAFTY	1
CASSARSGELFF	HPVGEADYFEY	1
CSARDGTGNGYTF	GLCTLVAML	1
CASRPGLAGGRPEQYF	LGYGFVNYI	1
CASSLSFGTEAFF	ELAGIGILTV	1
CASSLSFGTEAFF	AAGIGILTV	1
CAISEVGVGQPQHF	ELAGIGILTV	1
CAISEVGVGQPQHF	AAGIGILTV	1
CASRPGLAGGRPEQYF	LLFGFPVYV	1
CASGQGNFDIQYF	FLRGRAYGL	1
CASSLWEKLAKNIQYF	ALWGPDPAAA	1
CASSPTSGIYEQYF	RFPLTFGWCF	1
CASSSWDTGELFF	RYPLTFGWCF	1
CASSSWDTGELFF	RYPLTLGWCF	1
CASSFLGTGVEQYF	ALGIGILTV	1
CASRPGLMSAQPEQYF	LLFGYPVYV	1
CASREGLGGTEAFF	KRWIILGLNK	1
CASREGLGGTEAFF	KRWIIMGLNK	1
CASPGETEAFF	LPEPLPQGQLTAY	1
CASSRTGSTYEQYF	LPEPLPQGQLTAY	1
CASSWSFGTEAFF	ELAGIGILTV	1
CASSLTGGGELFF	TAFTIPSI	1
CASSYQGTEAFF	ILAKFLHWL	1
CASSARSGELFF	HPVGDADYFEY	1
CASSARSGELFF	HPVGQADYFEY	1
CAWSETGLGTGELFF	EAAGIGILTV	1
CASSLRGRGDQPQHF	HSKKKCDEL	1
CASSQTQLWETQYF	NLVPMVATV	1
CASSLAPGTTNEKLFF	NLVPMVATV	1
CASSDWVSYEQYF	ALWGFFPVL	1
CAWSVSVGAGVPTIYF	RYPLTFGWCF	1
CASSFLGTGVEQYF	EAAGIGILTV	1
CASSLEGGYYNEQFF	IPSINVHHY	1
CASRRGPYEQYF	KLVALVINAV	1
CASSFNMATGQYF	EVDPIGHLY	1
CASSFNMATGQYF	ESDPIVAQY	1
CASSLWEKLAKNIQYF	YQFGPDFPIA	1
CASSLWEKLAKNIQYF	RQWGPDPAAV	1
CASSLWEKLAKNIQYF	YLGGPDFPTI	1
CASSLWEKLAKNIQYF	MVWGPDPLYV	1
CASSLWEKLAKNIQYF	RQFGPDFPTI	1
CASSLWEKLAKNIQYF	RQFGPDWIVA	1
CASSLIYPGELFF	GILGFVFTL	1
CASRPGWMAGGVELYF	ELAGIGILTV	1
CASSFIGGTDTQYF	YLEPGPVTV	1
CASSIRSSYEQYF	GILGFVFTL	1
CASSSRSSYEQYF	GILGLVFTL	1
CASSIRSSYEQYF	GILEFVFTL	1
CASSLWEKLAKNIQYF	AQWGPDPAAA	1
CASSIFGQREQYF	GILGFVFTL	1
CASSIGVYGYTF	GILGFVFTL	1
CASRRGPYEQYF	KLVALGINAV	1
CASSQGLAGAGELFF	ELAGIGILTV	1
CASSDTVSYEQYF	SLYNTVATL	1
CASSDTVSYEQYF	SLYNTIATL	1
CASSDTVSYEQYF	SLFNTIAVL	1
CASSLLGGWSEAFF	GILGFVFTL	1
CASSANPGDSSNEKLFF	VMAPRTLIL	1
CASSANPGDSSNEKLFF	VMAPRTLVL	1
CASSLGQGLLYGYTF	GTSGSPIVNR	1
CASSLGQGLLYGYTF	GTSGSPIINR	1
CASRTRGGTLIEQYF	IPLTEEAEL	1
CASRRGSAELYF	KLVALGINAV	1
CASSLSFGTEAFF	SMLGIGIVPV	1
CASSLSFGTEAFF	MMWDRGLGMM	1
CASSQRQEGDTQYF	APRGPHGGAASGL	1
CASSGGHTGSNEQFF	APRGPHGGAASGL	1
CASSFRGGKTQYF	IPLTEEAEL	1
CASRTRGGTLIEQYF	VPLTEDAEL	1
CASSWSFGTEAFF	AAGIGILTV	1
CAWSETGLGTGELFF	AAGIGILTV	1
CASSMSAMGTEAFF	FEDLRVLSF	1
CASSRTSPTDTQYF	KQWLVWLFL	1
CASSPLDVSISSYNEQFF	SLSKILDTV	1
CASSSPGGVSTEAFF	SLLMWITQV	1
CSVGGSGGADTQYF	SLLMWITQV	1
CASSFLMTSGDPYEQYF	GVYDGREHTV	1
CASSDPGTEAFF	GADGVGKSAL	1
CASSITLSSYNEQFF	ITDQVPFSV	1
CASSITLSSYNEQFF	IMDQVPFSV	1
CASSMGGTYEQYF	ITDQVPFSV	1
CASSMGGTYEQYF	ILDQVPFSV	1
CASSQDLFTGGYTF	RPPIFIRRL	1
CASSIQQGADTQYF	HMTEVVRHC	1
CASSEGLWQVGDEQYF	HMTEVVRHC	1
CAISELVTGDSPLHF	HMTEVVRHC	1
CASSLGGAGGADTQYF	RLQSLQTYV	1
CASSPDIEQYF	YLQPRTFLL	1
CAGQVTNTGELFF	YLQPRTFLL	1
CASSYSIRGSRGEQFF	RLPAKAPLL	1
CASSYSIRGSRGEQFF	RLPAKAPLLGCG	1
CASSYSIRGSRGEQFF	RLPAKAPL	1
CASSLGIDAIYF	TPQDLNTML	1
CASSLGREYGYTF	RMYSPVSIL	1
CASSLGREYGYTF	RMYSPVSI	1
CASSLDPGDTGELFF	HMTEVVRHC	1
CASSGLAGGPVSGANVLTF	ALHGGWTTK	1
CASSLVAETYEQYF	ALHGGWTTK	1
CSVVDAAPGANVLTF	LLWNGPMAV	1
CAWSPGPVNEQFF	LLWNGPMAV	1
CSARASYEQYF	LLWNGPMAV	1
CASSDSGTDTQYF	LLWNGPMAV	1
CASSFLAGGNEQFF	LLWNGPMAV	1
CAWSGDRAMVSGELFF	LLWNGPMAV	1
CASSEGANTEAFF	LLWNGPMAV	1
CSASRRGGTNEKLFF	LLWNGPMAV	1
CASRKTGYTGELFF	LLWNGPMAV	1
CASSMRRGTDTQYF	LLWNGPMAV	1
CASSHWREESEQFF	LLWNGPMAV	1
CSARDAPSRETQYF	LLWNGPMAV	1
CASGGTGATYSNQPQHF	LLLGIGILV	1
CASRPDFTGEQYF	LLLGIGILV	1
CASSPTSIANTGELFF	LLLGIGILV	1
CASSTASYEQYF	LLLGIGILV	1
CSGGQGDGYTF	LLLGIGILV	1
CASSQGPFREEAFF	LLLGIGILV	1
CATSDLSQGVDTQYF	LLLGIGILV	1
CASSQGQLNTGELFF	LLLGIGILV	1
CASSVGRFVGPYEKLFF	LLLGIGILV	1
CSASRPLGGLSYEQYF	NEGVKAAW	1
CASSLMGGAHYGYTF	NEGVKAAW	1
CASSFTLGGTDTQYF	NEGVKAAW	1
CASSIVSGPYNEQFF	NEGVKAAW	1
CASSIFGEQFF	NEGVKAAW	1
CASIPTAMNTEAFF	NEGVKAAW	1
CASSLVQGTYEQYF	NEGVKAAW	1
CASSFFGNSYEQYF	NEGVKAAW	1
CSVEPSGGSNEQFF	NEGVKAAW	1
CASSLEGGGYEQYF	NEGVKAAW	1
CASSIFGELFF	NEGVKAAW	1
CASSFAGELFF	NEGVKAAW	1
CASRQRVLASDEQFF	NEGVKAAW	1
CASSYVRTAEQFF	NEGVKAAW	1
CASSVFGEQYF	NEGVKAAW	1
CASSLVIAGLQETQYF	NEGVKAAW	1
CASSTIAGGYNEQFF	NEGVKAAW	1
CASSLSAHAGDTQYF	NEGVKAAW	1
CASRQQGGSTEAFF	NEGVKAAW	1
CSATLNWGFF	NEGVKAAW	1
CASSKVRRGRADEQFF	NEGVKAAW	1
CASSVFGELFF	NEGVKAAW	1
CASSSDRSWTDEAFF	NEGVKAAW	1
CASSIGQGPYEQYF	NEGVKAAW	1
CASSPRSGNEQYF	NEGVKAAW	1
CASSLGPQNTGELFF	NEGVKAAW	1
CASSIVAGALNEQFF	NEGVKAAW	1
CASSFTSGSYGSSYNEQFF	NEGVKAAW	1
CSASGGALSSYNEQFF	NEGVKAAW	1
CASSLASRGGAYNEQFF	NEGVKAAW	1
CASSITGTGEAFF	NEGVKAAW	1
CASSYRRPSSYNEQFF	NEGVKAAW	1
CANTSIGSGANVLTF	NEGVKAAW	1
CASSNWDSQETQYF	NEGVKAAW	1
CASSIAGRGGYSPLHF	NEGVKAAW	1
CATSEAANTGELFF	QASQEVKNW	1
CASSMIQGADTQYF	TPQDLNTML	1
CASSYGGTGPEGSSYEQYF	TPQDLNTML	1
CASSESTGTAYGYTF	NLVPMVATV	1
CASSLGNYEQYF	VLEETSVML	1
CASSLSTGGALGTIYF	VLEETSVML	1
CASSLTSGGPDTQYF	NLVPMVATV	1
CASSWDSQSSGNSIYF	VLEETSVML	1
CSVSEGASEQYF	VLEETSVML	1
CSVWGTGKTYEQYF	FLKEKGGL	1
CSVWGEGRSYEQYF	FLKEKGGL	1
CSATILAGVPYGEQYF	FLKEKGGL	1
CASSFDREVTGELFF	FLKEKGGL	1
CASSVGAGTEAFF	FLKEKGGL	1
CASSWGQGQLSYEQYF	FLKEKGGL	1
CASSIFGSPFNQPQHF	FLKEKGGL	1
CASSLGQGLANYGYTF	FLKEKGGL	1
CSARPMAASGLTYEQYF	FLKEKGGL	1
CASSEYGAAVYEQYF	FLKEKGGL	1
CASSLNLRGSSGNTIYF	FLKEKGGL	1
CASSSNPGTSGGYSYEQYF	FLKEKGGL	1
CASSLLGQYNEQFF	FLKEKGGL	1
CASSFHPGQGASYSNQPQHF	FLKEKGGL	1
CASSYERGGLPKNIQYF	FLKEKGGL	1
CASSLGQGRSLGHEQYF	FLKEKGGL	1
CSARQYRTDMNTEAFF	ILKEPVHGV	1
CSVEVGAGETQYF	ILKEPVHGV	1
CASSYEWGGLPKNIQYF	ILKEPVHGV	1
CASRLVGIGNSPLHF	ILKEPVHGV	1
CAISEDGGETQYF	ILKEPVHGV	1
CASSFGGDEQHF	ILKEPVHGV	1
CASSEPALAEQYYEQYF	FLKEKGGL	1
CASSFTPGTGAPYSNQPQHF	FLKEKGGL	1
CSVEGGSAYEQYF	FLKEKGGL	1
CSAHLYRAYGYTF	FLKEKGGL	1
CASSMGQHSNQPQHF	FLKEKGGL	1
CASKWDPGQGSHYSNQPQHF	FLKEKGGL	1
CSVEPSGRARTYNEQFF	FLKEKGGL	1
CAWDVKDRRIGNEQFF	FLKEKGGL	1
CSARDSGRGIENYEQYF	FLKEKGGL	1
CSASSQRGGIYEQYF	FLKEKGGL	1
CASSLELAGEDYEQYF	FLKEKGGL	1
CSVRDGYEQYF	EIYKRWII	1
CASSPVRGRTEAFF	EIYKRWII	1
CASSLVGPGGREKLFF	EIYKRWII	1
CASSVLTGGRETQYF	EIYKRWII	1
CASSIIKGNQPQHF	EIYKRWII	1
CASSSGLPTNEKLFF	EIYKRWII	1
CASSVVGDFRETQYF	EIYKRWII	1
CASSYGGTEAFF	EIYKRWII	1
CASSLPGQGRTPLHF	EIYKRWII	1
CASSFLPKNEQFF	EIYKRWII	1
CSARLSYEQYF	EIYKRWII	1
CASSAITSGGARDEQFF	EIYKRWII	1
CATIRTGFSSYEQYF	EIYKRWII	1
CASSYSRGSGNTIYF	QVPLRPMTYK	1
CASRQQGFVFEAKNIQYF	QVPLRPMTYK	1
CSAPTSGSAAFF	QVPLRPMTYK	1
CASRPGPVKNTGELFF	QVPLRPMTYK	1
CASSLTGHPYEQYF	QVPLRPMTYK	1
CSVEDRHYEQYF	QVPLRPMTYK	1
CASSYSRGAGNTIYF	QVPLRPMTYK	1
CASSLTAPDTEAFF	KRWIILGLNK	1
CASSRSTGELFF	KRWIILGLNK	1
CASSVRTGELFF	KRWIILGLNK	1
CASSPRTGELFF	KRWIILGLNK	1
CASSGQGYGYTF	KAFSPEVIPMF	1
CASTGGGYGYTF	KAFSPEVIPMF	1
CASSGQDYGYTF	KAFSPEVIPMF	1
CASTDSYGYTF	KAFSPEVIPMF	1
CASSGGSYGYTF	KAFSPEVIPMF	1
CASSPSMSTGELFF	YLQPRTFLL	1
CSARDHVGQNTGELFF	YLQPRTFLL	1
CASSFGISGELFF	YLQPRTFLL	1
CATSPDPNTGELFF	YLQPRTFLL	1
CASGTANTGELFF	YLQPRTFLL	1
CASSDMNTGELFF	YLQPRTFLL	1
CASSLWTGSEAFF	YLQPRTFLL	1
CASSYQQGPEAFF	YLQPRTFLL	1
CAGGDTNTGELFF	YLQPRTFLL	1
CATEDRNTGELFF	YLQPRTFLL	1
CASADMNTGELFF	YLQPRTFLL	1
CASSPDPNTGELFF	YLQPRTFLL	1
CASSPMMDEQFF	YLQPRTFLL	1
CATSRPATEAFF	YLQPRTFLL	1
CANPDRNTGELFF	YLQPRTFLL	1
CASSSANSGELFF	YLQPRTFLL	1
CATTELDTGELFF	YLQPRTFLL	1
CASSSSVNEQFF	RLQSLQTYV	1
CASSPRDREESEQYF	RLQSLQTYV	1
CASSLSSTGDGYTF	RLQSLQTYV	1
CATSVQGQTGELFF	RLQSLQTYV	1
CASSLAQGTYNEQFF	RLQSLQTYV	1
CASSIDERAQPQHF	RLQSLQTYV	1
CASSGENTEAFF	RLQSLQTYV	1
CASSEAKSDAYEQYF	RLQSLQTYV	1
CASSPPGPSLNEQFF	RLQSLQTYV	1
CASSTTGEANEKLFF	RLQSLQTYV	1
CASSPRGQGGTGELFF	RLQSLQTYV	1
CASSLENRPTYEQYF	RLQSLQTYV	1
CASSNSGSRIDGYTF	RLQSLQTYV	1
CASSQAVGGTNTDTQYF	RLQSLQTYV	1
CASSGEGGHSNQPQHF	RLQSLQTYV	1
CAFLGGSGANVLTF	RLQSLQTYV	1
CASSHVSPNTGELFF	RLQSLQTYV	1
CASSLMGSNGELFF	RLQSLQTYV	1
CASSLLDRNTEAFF	RLQSLQTYV	1
CASSIVEGASYEQYF	RLQSLQTYV	1
CATSEAASSWTGELFF	RPRGEVRFL	1
CASRPQGREETQYF	RPRGEVRFL	1
CASRIWGGADTQYF	RPRGEVRFL	1
CASSEWTVDGYTF	RPRGEVRFL	1
CSALRDNYNSPLHF	RPRGEVRFL	1
CASRLTGEKQETQYF	RPRGEVRFL	1
CATRIGWGTDTQYF	RPRGEVRFL	1
CASSVWGTDTQYF	RPRGEVRFL	1
CASRLIGGGTEAFF	RPRGEVRFL	1
CASSSTPLSTDTQYF	RPRGEVRFL	1
CASRMQGRDNEQFF	RPRGEVRFL	1
CAISDPGDTQYF	RPRGEVRFL	1
CASRPQGRDQPQHF	RPRGEVRFL	1
CASSPYQTGLDGYTF	RPRGEVRFL	1
CASRLQGINEKLFF	RPRGEVRFL	1
CASSLGGLGDTQYF	RPRGEVRFL	1
CASSVIGATYEQYF	RPRGEVRFL	1
CASSVQALLAGDWADTQYF	RPRGEVRFL	1
CAISDPSGSSYNEQFF	RPRGEVRFL	1
CAWTETGLSGNTIYF	RPRGEVRFL	1
CASSLASWGNEKLFF	RPRGEVRFL	1
CASRRQGRDNEQFF	RPRGEVRFL	1
CASRPQGANEKLFF	RPRGEVRFL	1
CASRKTGGGEAFF	RPRGEVRFL	1
CASSTDSVDEQFF	RPRGEVRFL	1
CASRPQGRDNEQFF	RPRGEVRFL	1
CASSPTGGSPSPLHF	NLVPMVATV	1
CASSVVGDEQYF	YSEHPTFTSQY	1
CASSADSNGELFF	IPSINVHHY	1
CASSLGSYEQYF	GTSGSPIVNR	1
CASSLVGGTPSYNEQFF	GTSGSPIVNR	1
CASSLFAGGPDTQYF	GTSGSPIVNR	1
CASSWGAAEAFF	GTSGSPIVNR	1
CASSLVIPTGWRDNEQFF	GTSGSPIVNR	1
CASSLNSGSAGELFF	GTSGSPIVNR	1
CASNLGTEETQYF	GTSGSPIVNR	1
CASSLGPDNEQFF	GTSGSPIVNR	1
CASSPGVEKLFF	GTSGSPIVNR	1
CASSLGVPEAFF	GTSGSPIVNR	1
CASTPLWGDQETQYF	GTSGSPIVNR	1
CASSLGYQGYEQFF	GTSGSPIVNR	1
CASSSGSYEQYF	GTSGSPIVNR	1
CASSLGSAEAFF	GTSGSPIVNR	1
CASSLGQGAYEQYF	GTSGSPIVNR	1
CASSPGTAEAFF	GTSGSPIVNR	1
CASSWGSYEQFF	GTSGSPIVNR	1
CASSPGTDEAFF	GTSGSPIVNR	1
CASSLTAGTQETQYF	GTSGSPIVNR	1
CASTPGLWNTEAFF	GTSGSPIVNR	1
CASSPGTEHGYTF	GTSGSPIVNR	1
CASGLGSYEQYF	GTSGSPIVNR	1
CASSGGTSFREQFF	GTSGSPIVNR	1
CASSPGGARAFF	GTSGSPIVNR	1
CASSLAGGGAYEQYF	GTSGSPIVNR	1
CASSIGVETQYF	GTSGSPIVNR	1
CASSPGTLHGYTF	GTSGSPIVNR	1
CASSQGGGNYEQYF	GTSGSPIVNR	1
CASRLAASYNEQFF	GTSGSPIIDK	1
CASSGPRDGRGNEKLFF	GTSGSPIIDK	1
CASTKGFSGNTIYF	GTSGSPIIDK	1
CASRLNRGPGEQYF	GTSGSPIIDK	1
CASSLSGTDTQYF	GTSGSPIINR	1
CASSQDPGLNEKLFF	GTSGSPIINR	1
CATSDHSTSGRRNEQFF	GTSGSPIINR	1
CASSLGAGDRSYEQYF	GTSGSPIINR	1
CASSQMTGTGELFF	GTSGSPIIDK	1
CATSRDRGISNYGYTF	GTSGSPIIDK	1
CAIRAGTATYGYTF	GTSGSPIIDK	1
CASSGNEQFF	GTSGSPIIDK	1
CASSLKGGWAYNEQFF	GTSGSPIIDK	1
CASSQRSRDRGAFF	GTSGSPIIDK	1
CASSYTFRDTKETQYF	GTSGSPIIDK	1
CASSWPEETQYF	GTSGSPIINR	1
CASSLGGGNQETQYF	GTSGSPIINR	1
CASSGGAAYEQYF	GTSGSPIINR	1
CASSPSQDTEAFF	GTSGSPIINR	1
CASSGGQGNIQYF	GTSGSPIIDK	1
CASSLIGGGNTEAFF	GTSGSPIIDK	1
CASSRGLNYEQYF	GTSGSPIIDK	1
CASSRAGGTASYEQYF	GTSGSPIIDK	1
CASSGGSGNIQYF	GTSGSPIIDK	1
CASSLGGGLQETQYF	GTSGSPIIDK	1
CASSAFSGFQETQYF	GTSGSPIIDK	1
CASSGGQGNIQYF	GTSGSPIINR	1
CASSLIGGGNTEAFF	GTSGSPIINR	1
CASSRGLNYEQYF	GTSGSPIINR	1
CASSRAGGTASYEQYF	GTSGSPIINR	1
CASSGGSGNIQYF	GTSGSPIINR	1
CASSLGGGLQETQYF	GTSGSPIINR	1
CASSAFSGFQETQYF	GTSGSPIINR	1
CASSLGGGNQETQYF	GTSGSPIIDK	1
CASSAYQGTGELFF	GTSGSPIVNR	1
CASSLHGTSKLNEQFF	GTSGSPIVNR	1
CASSFGGASYEQYF	GTSGSPIVNR	1
CASSFGNPEAFF	GTSGSPIVNR	1
CATGTGGGGYTF	GTSGSPIVNR	1
CASSPSWGRNQPQHF	GTSGSPIVNR	1
CASSPPLAGGPYNEQFF	GTSGSPIVNR	1
CASSQGGYSNQPQHF	GTSGSPIVNR	1
CSARDPGEYQETQYF	GTSGSPIVNR	1
CASSLGTREAFF	GTSGSPIVNR	1
CASSRGAGEQETQYF	GTSGSPIINR	1
CASSVWGDPSYEQYF	GTSGSPIINR	1
CASSVADAGAISSGANVLTF	GTSGSPIINR	1
CASSLFLMGLAGGNEQFF	GTSGSPIINR	1
CASSLGQGYEQYF	GTSGSPIINR	1
CASSLYTGSYNEQFF	GTSGSPIINR	1
CASSVGGEQFF	GTSGSPIINR	1
CASSDGIQYF	GTSGSPIINR	1
CASSYGTEQPQHF	GTSGSPIVNR	1
CASSLGGTDNEQFF	GTSGSPIVNR	1
CASSLGGDTYEQYF	GTSGSPIVNR	1
CASRRPREGLANEQFF	GTSGSPIVNR	1
CASSLGQGAYEQYF	GTSGSPIINR	1
CASSYGTEQPQHF	GTSGSPIINR	1
CASSLGGTDNEQFF	GTSGSPIINR	1
CASSLGGDTYEQYF	GTSGSPIINR	1
CASRRPREGLANEQFF	GTSGSPIINR	1
CASSLGAPEAFF	GTSGSPIVNR	1
CASSLGQGTYEQYF	GTSGSPIVNR	1
CASSLGGQTYEQYF	GTSGSPIVNR	1
CASSLGAGVQETQYF	GTSGSPIVNR	1
CASSLAGVGNEQFF	GTSGSPIVNR	1
CASSLGAPEAFF	GTSGSPIINR	1
CASSLGQGTYEQYF	GTSGSPIINR	1
CASSLGGQTYEQYF	GTSGSPIINR	1
CASSLGAGVQETQYF	GTSGSPIINR	1
CASSLAGVGNEQFF	GTSGSPIINR	1
CASSMGQGDYEQYF	GTSGSPIVNR	1
CASSPTGGGYEQYF	GTSGSPIVNR	1
CASSMGQGDYEQYF	GTSGSPIINR	1
CASSPTGGGYEQYF	GTSGSPIINR	1
CASSFGAGSQETQYF	GTSGSPIVNR	1
CASSLGQGDFEQYF	GTSGSPIVNR	1
CASSPAGGTYEQYF	GTSGSPIVNR	1
CASSLGPEAPLFF	GTSGSPIVNR	1
CASSFGAGSQETQYF	GTSGSPIINR	1
CASSLGQGDFEQYF	GTSGSPIINR	1
CASSPAGGTYEQYF	GTSGSPIINR	1
CASSLGPEAPLFF	GTSGSPIINR	1
CASLSGRAPQHF	GTSGSPIVNR	1
CASSLVIIGSASTDTQYF	GTSGSPIVNR	1
CASSLQPSGTSFYNEQFF	GTSGSPIVNR	1
CASLSGRAPQHF	GTSGSPIINR	1
CASSLVIIGSASTDTQYF	GTSGSPIINR	1
CASSLQPSGTSFYNEQFF	GTSGSPIINR	1
CASSLGTREAFF	GTSGSPIINR	1
CASTTGGGGYEQYF	GTSGSPIVNR	1
CASTTGGGGYEQYF	GTSGSPIINR	1
CASSLGQGSYEQYF	GTSGSPIVNR	1
CASSLGQGSYEQYF	GTSGSPIINR	1
CASSPAPSASSYEQYF	KLVALGINAV	1
CASSWSASYEQYF	KLVALGINAV	1
CASSSSWADTQYF	KLVALGINAV	1
CASGQGQETQYF	KLVALGINAV	1
CASSMGANEQFF	KLVALGINAV	1
CASSLAQGQPQHF	KLVALGINAV	1
CASSYWQGELFF	KLVALGINAV	1
CASTNRQEGQETQYF	KLVALGINAV	1
CASSPGGELFF	KLVALGINAV	1
CAISGQAVSTDTQYF	KLVALGINAV	1
CASSPYPRGGTGELFF	KLVALGINAV	1
CASSPADPFSNTQYF	KLVALGINAV	1
CSANSRTGLGYTF	KLVALGINAV	1
CASSYGSYEQYF	KLVALGINAV	1
CASSWGGGEQYF	KLVALGINAV	1
CASSLEGSYEQYF	KLVALGINAV	1
CSAIDFPMGNEQFF	KLVALGINAV	1
CASSSRHEGEDTEAFF	KLVALGINAV	1
CASREDGASGSPDTQYF	KLVALGINAV	1
CASKMGAEAFF	KLVALGINAV	1
CASSLGGDIQYF	KLVALGINAV	1
CASTGGLGYTF	KLVALGINAV	1
CASSYQSGNTEAFF	KLVALGINAV	1
CASNRGDGYTF	KLVALGINAV	1
CASSIALSDNYGYTF	KLVALGINAV	1
CAWSINSAEAFF	KLVALGINAV	1
CASSDSYGYTF	KLVALGINAV	1
CASSLEREGRGEQFF	KLVALGINAV	1
CASSQGSYEQYF	KLVALGINAV	1
CASTQSPLAGNEQYF	KLVALGINAV	1
CASSGYTGELFF	KLVALGINAV	1
CASTNSGNTIYF	KLVALGINAV	1
CASSSGATEAFF	KLVALGINAV	1
CASSQVGQNLYEQYF	KLVALGINAV	1
CASSVEGGGAKETQYF	KLVALGINAV	1
CASSIGHNTGELFF	KLVALGINAV	1
CASTQGSTDTQYF	KLVALGINAV	1
CASSVAIWRGSYNEQFF	KLVALGINAV	1
CASSSPGASTYEQYF	KLVALGINAV	1
CASSYNIAGELFF	KLVALGINAV	1
CASSIAGSAYEQYF	KLVALGINAV	1
CASSIRRIDPYNEQFF	KLVALGINAV	1
CASSVELAGTYEQYF	KLVALGINAV	1
CASSYTGELFF	KLVALGINAV	1
CASSFGADTQYF	KLVALGINAV	1
CASSAETQYF	KLVALGINAV	1
CASSSPHRDSYSPLHF	KLVALGINAV	1
CASSQETQYF	KLVALGINAV	1
CASSIGQYEQYF	KLVALGINAV	1
CASSYRGSGNTIYF	KLVALGINAV	1
CASSYAQGNEQFF	KLVALGINAV	1
CASSLGRGQFF	KLVALGINAV	1
CASSRGDTEAFF	KLVALGINAV	1
CASSLWSAGVHNEQFF	KLVALGINAV	1
CASSEGDTEAFF	KLVALGINAV	1
CASSVEGIDEKLFF	KLVALGINAV	1
CATSSGDLSSGANVLTF	KLVALGINAV	1
CATSIDRGREKLFF	KLVALGINAV	1
CASSMGGNPEQYF	KLVALGINAV	1
CASSDDRGPYEQYF	KLVALGINAV	1
CASSQVRLNTEAFF	KLVALGINAV	1
CASSRSLNVNSNQPQHF	KLVALGINAV	1
CASSLGEKLFF	KLVALGINAV	1
CASDSNTEAFF	KLVALGINAV	1
CASSMGGEQYF	KLVALGINAV	1
CASSPSYNEQFF	RLITGRLQSL	1
CASSLDIPSYNEQFF	NLVPMVATV	1
CASSSPDRGGTNEKLFF	RLITGRLQSL	1
CSGEGGDTEAFF	RLITGRLQSL	1
CSARDPGLEQNIQYF	RLITGRLQSL	1
CASSQEGDRVTEAFF	RLITGRLQSL	1
CSARSPGELNIQYF	RLITGRLQSL	1
CSASSTHSNQPQHF	KQIYKTPPI	1
CASSLTGGGYEQYF	LLFNKVTLA	1
CASSQEQEPHQETQYF	RLITGRLQSL	1
CASSIAGNNEQFF	TLATHGLAAV	1
CASSVGGGGSTDTQYF	FPQSAPHGVVF	1
CASSIALSTFQPQHF	MQLFFSYFA	1
CASSLGEPQHF	YPDKVFRSSV	1
CASSVGGGGSTDTQYF	YPDKVFRSSV	1
CASRTLRGHVSEAFF	ALQIPFAMQM	1
CASSFPGYGYTF	KIYSKHTPI	1
CASSKKGLSNEQFF	LPPAYTNSF	1
CASSLMVNEQYF	FAMQMAYRF	1
CATFTGNTEAFF	RARSVASQSI	1
CASSLDGTGREKLFF	FAMQMAYRF	1
CASSFGTPSTDTQYF	FAMQMAYRF	1
CASSSLDGRLGYTF	LPPAYTNSF	1
CASSSAHYGYTF	MLAKALRKV	1
CSARTGTSEYNEQFF	RLITGRLQSL	1
CASSPDDRESSYNEQFF	MLAKALRKV	1
CASSLWLNEQFF	NLVPMVATV	1
CASSPKTGASYGYTF	NLVPMVATV	1
CASSFVSFDEQFF	NLVPMVATV	1
CASSSAYYGYTF	NLVPMVATV	1
CASSADSYGANVLTF	NLVPMVATV	1
CSVDPGHTGEKLFF	NLVPMVATV	1
CASSLVGGRHGYTF	NLVPMVATV	1
CASSHDPTWGPGNTIYF	NLVPMVATV	1
CASSFGQGSSPLHF	NLVPMVATV	1
CASSLETVNTEAFF	NLVPMVATV	1
CASSSFYDSNEKLFF	NLVPMVATV	1
CASSLASPGHFTGELFF	NLVPMVATV	1
CASRRQGTVYEQYF	NLVPMVATV	1
CASRIELPGAGELFF	NLVPMVATV	1
CASSLGFLGPAAGNTIYF	NLVPMVATV	1
CSARDHGGDYGYTF	NLVPMVATV	1
CASSLEVTGLNTEAFF	NLVPMVATV	1
CASSDSGEAGELFF	NLVPMVATV	1
CSGGQDYNEQFF	NLVPMVATV	1
CASSEDSGGYNEQFF	NLVPMVATV	1
CASSDSTSGGNEQFF	NLVPMVATV	1
CSARDMASGRNEQYF	NLVPMVATV	1
CASSPGGGMNTEAFF	NLVPMVATV	1
CASSFDPGSYGYTF	NLVPMVATV	1
CASSPASGSLFF	NLVPMVATV	1
CASSEGLGGALYGYTF	NLVPMVATV	1
CASSPDYDQETQYF	NLVPMVATV	1
CASTHGTSGEDTQYF	NLVPMVATV	1
CASLPTGTNTGELFF	NLVPMVATV	1
CASSLQGASGYTF	NLVPMVATV	1
CASTGGGALGTEAFF	NLVPMVATV	1
CASSIVAGGYNEQFF	NLVPMVATV	1
CASSRDRTGRANYGYTF	NLVPMVATV	1
CASSPRTSFETQYF	NLVPMVATV	1
CASSPGTFRYTF	NLVPMVATV	1
CASSPTDRGNTGELFF	NLVPMVATV	1
CASSGRGFLNYGYTF	NLVPMVATV	1
CASSLVGTGELFF	NLVPMVATV	1
CASSHGAAAGETEAFF	NLVPMVATV	1
CASGSGLAGNEQFF	NLVPMVATV	1
CASSVGLGFTDTQYF	NLVPMVATV	1
CASSEARQGLDTEAFF	NLVPMVATV	1
CASSLFAGAETQYF	NLVPMVATV	1
CASRKLAGPTDTQYF	NLVPMVATV	1
CATSATGLRNQPQHF	NLVPMVATV	1
CASSLESWGRAYNEQFF	NLVPMVATV	1
CASLAGVRTDTQYF	NLVPMVATV	1
CASSNFLGQGDEKLFF	NLVPMVATV	1
CASSEPIGTGGNQPQHF	NLVPMVATV	1
CASRQENSGNTIYF	NLVPMVATV	1
CASSSQGWGRVYSEQFF	NLVPMVATV	1
CSATPSGYGYTF	NLVPMVATV	1
CASSVEVGTGDNEQFF	NLVPMVATV	1
CASSIQKAGYNEQFF	NLVPMVATV	1
CAAGTRTDTQYF	NLVPMVATV	1
CASSVDSGSTNEQFF	NLVPMVATV	1
CASSLGTGELFF	NLVPMVATV	1
CASSLSGVPHNNEQFF	NLVPMVATV	1
CASSQTRTSGRVDPDTQYF	NLVPMVATV	1
CASRRPGGDTEAFF	NLVPMVATV	1
CASSLNSGLYNEQFF	NLVPMVATV	1
CASSLNGRADTQYF	NLVPMVATV	1
CASSRQESYGYTF	NLVPMVATV	1
CAISEQEDQPQHF	NLVPMVATV	1
CASSVEGQGDTEAFF	NLVPMVATV	1
CASSPLRGVYYNEQFF	NLVPMVATV	1
CASTPYRRGPHLYGYTF	NLVPMVATV	1
CASSLVVMGTGFTDTQYF	NLVPMVATV	1
CASSLAQQGLAEAFF	NLVPMVATV	1
CASSPSTGTIYGYTF	NLVPMVATV	1
CAISESRSRVTDTQYF	NLVPMVATV	1
CASSPSDYGYTF	NLVPMVATV	1
CAISEYPPTGRKADTQYF	NLVPMVATV	1
CASSQVGTVYGYTF	NLVPMVATV	1
CSAADRGLGETQYF	NLVPMVATV	1
CASRGTGGGSGQPQHF	NLVPMVATV	1
CASSYDRGPREGYTF	NLVPMVATV	1
CASSTRSTGELFF	NLVPMVATV	1
CASSLRGQGFYEQFF	NLVPMVATV	1
CSGDRSSDTQYF	NLVPMVATV	1
CASSPSWGEVNTEAFF	NLVPMVATV	1
CASSPGYGSSGNTIYF	NLVPMVATV	1
CASSPPGLPGYTF	NLVPMVATV	1
CASSPGQLQETQYF	NLVPMVATV	1
CASSSGLAGVETGELFF	NLVPMVATV	1
CASSLQVWNEQFF	NLVPMVATV	1
CASSLQGIGAKNIQYF	NLVPMVATV	1
CASSSGGLSEQYF	NLVPMVATV	1
CSARGADTQYF	NLVPMVATV	1
CASSLELAAWETQYF	NLVPMVATV	1
CSARDLRLLANTGELFF	NLVPMVATV	1
CASSTGSYGYTF	NLVPMVATV	1
CASSSGIYGYTF	NLVPMVATV	1
CASSLAGFTGELFF	NLVPMVATV	1
CASSPTLVTSGNTIYF	NLVPMVATV	1
CASSEGYIYEQYF	NLVPMVATV	1
CASSYASNQPQHF	NLVPMVATV	1
CAISVSGTRVYNEQFF	NLVPMVATV	1
CASSLGQGNSPLHF	NLVPMVATV	1
CASSLKAGNQPQHF	NLVPMVATV	1
CASSVGTLYSGANVLTF	NLVPMVATV	1
CASSLLGGAGTGELFF	NLVPMVATV	1
CSVEGDTGELFF	NLVPMVATV	1
CASSQGLAGEVYTGELFF	NLVPMVATV	1
CASSLDRPSGMAAETQYF	NLVPMVATV	1
CASSINRDLLNGYTF	NLVPMVATV	1
CASSYWDRTTSGNTIYF	NLVPMVATV	1
CASSHTSGNGDTQYF	NLVPMVATV	1
CASSDSRANTGELFF	NLVPMVATV	1
CSARLPRDYSNQPQHF	NLVPMVATV	1
CASSLAEKANTGELFF	NLVPMVATV	1
CSILGSNAGPQETQYF	NLVPMVATV	1
CAIDRVGTGELFF	NLVPMVATV	1
CASTGSVSTDTQYF	NLVPMVATV	1
CASSRGHPLQFF	NLVPMVATV	1
CASSISAGVGVGQETQYF	NLVPMVATV	1
CASSLVGGPSVQFF	NLVPMVATV	1
CATSDSAGYNEQFF	NLVPMVATV	1
CASSVTGTEADEQFF	NLVPMVATV	1
CASSPPGTSGGRNEQFF	NLVPMVATV	1
CASSDRLENNEKLFF	NLVPMVATV	1
CASTRESTDTQYF	NLVPMVATV	1
CASSLGGTGWTEAFF	NLVPMVATV	1
CASSFKDTNTGELFF	NLVPMVATV	1
CASSLGAANYNEQFF	NLVPMVATV	1
CATSEGNEQFF	NLVPMVATV	1
CASSSRTGDQETQYF	NLVPMVATV	1
CASSSVNVAFF	NLVPMVATV	1
CASSDPGVDRNTEAFF	NLVPMVATV	1
CASSHGTGYNQPQHF	NLVPMVATV	1
CASSLEIQGSGAFF	NLVPMVATV	1
CASSDGIGQGASGYTF	NLVPMVATV	1
CASSARGGGNNEQFF	NLVPMVATV	1
CASSYSGTNQPQHF	NLVPMVATV	1
CASSYSGTGDYGYTF	NLVPMVATV	1
CASSPVGGDYGYTF	NLVPMVATV	1
CASSLDLYGYTF	NLVPMVATV	1
CSARDRGGENTGELFF	NLVPMVATV	1
CASSFQGIRVEAFF	NLVPMVATV	1
CASSPPGRGNTGELFF	NLVPMVATV	1
CASSFGQRDRGYWRNTEAFF	NLVPMVATV	1
CASGFTGGRNTEAFF	NLVPMVATV	1
CASSIVAGAGAGELFF	NLVPMVATV	1
CATSDLLAGGKTGELFF	NLVPMVATV	1
CASSATGSNTGELFF	NLVPMVATV	1
CASSMGTVYLNTEAFF	NLVPMVATV	1
CASSLLGVSYYNEQFF	NLVPMVATV	1
CASSTRGGGDAKNIQYF	NLVPMVATV	1
CAWVPGTGGRAAFF	NLVPMVATV	1
CASSVVGYLGYTF	NLVPMVATV	1
CASSRGQGPGQETQYF	NLVPMVATV	1
CASSQAPSMEPNEQFF	NLVPMVATV	1
CASSHQTGELFF	NLVPMVATV	1
CASSYNEQFF	NLVPMVATV	1
CASSIDAGSNYEQYF	NLVPMVATV	1
CASSYTVQPYNEQFF	NLVPMVATV	1
CATSDLRRTDTQYF	NLVPMVATV	1
CASSRDSNSNQPQHF	NLVPMVATV	1
CASSHERDRDTGELFF	NLVPMVATV	1
CASSSAFYGYTF	NLVPMVATV	1
CASSLAYILGLGDEQFF	NLVPMVATV	1
CASSDALQETQYF	NLVPMVATV	1
CASSLASRVGSPLHF	NLVPMVATV	1
CASSLSAVHGYTF	NLVPMVATV	1
CASSLKIGEQFF	NLVPMVATV	1
CASSLAGDYEQYF	NLVPMVATV	1
CASSELAGGGDTQYF	NLVPMVATV	1
CASSQQETYEQYF	NLVPMVATV	1
CSVVDYGYTF	NLVPMVATV	1
CSVAGQGDDHTDTQYF	NLVPMVATV	1
CSAPFPGQGDYGYTF	NLVPMVATV	1
CASSPSREGYTF	NLVPMVATV	1
CASSSGTSGSGSYNEQFF	NLVPMVATV	1
CASSIVGGMNTEAFF	NLVPMVATV	1
CASFSPRVYEQYF	NLVPMVATV	1
CSVEEGSRAQYF	NLVPMVATV	1
CASSIGTGGSQPQHF	LPEPLPQGQLTAY	1
CASSKLGTSEETQYF	LPEPLPQGQLTAY	1
CASPGLAGEYEQYF	GPEPLPQGQLTAY	1
CASPGLAGEYEQYF	LPEGLPQGQLTAY	1
CASPGLAGEYEQYF	LPEPLGQGQLTAY	1
CASPGLAGEYEQYF	LPEPLPQAQLTAY	1
CASPGLAGEYEQYF	LPEPLPQGGLTAY	1
CASPGLAGEYEQYF	LPEPLPQGQGTAY	1
CASPGLAGEYEQYF	LPEPLPQGQLGAY	1
CASPGLAGEYEQYF	LPEPLPQGQLTGY	1
CSARDRIGNGYTF	GLCTLVAML	1
CSARDRTGNGYTF	GLCTLVAML	1
CSARSGVGNTIYF	GLCTLVAML	1
CSVGSTGGTNEKLFF	GLCTLVAML	1
CSVGSAGTNEKLFF	GLCTLVAML	1
CSVREDSTNEKLFF	GLCTLVAML	1
CASSQSPGGIQYF	GLCTLVAML	1
CASSTGQVSPGELFF	GLCTLVAML	1
CASSEGRVSPGELFF	GLCTLVAML	1
CASSEGRISPGELFF	GLCTLVAML	1
CASSEGNVAPGELFF	GLCTLVAML	1
CSARSGTGGDYTF	GLCTLVAML	1
CSARDSTGNGYTF	GLCTLVAML	1
CASSSGLVAPGELFF	GLCTLVAML	1
CSVGTATNEKLFF	GLCTLVAML	1
CASSQSPGGTQYF	GLCTLVAML	1
CSARDWTGNGYTF	GLCTLVAML	1
CASSQSPGGFQYF	GLCTLVAML	1
CASSDGAILPGELFF	GLCTLVAML	1
CSARDATGNGYTF	GLCTLVAML	1
CSARDQTGNGYTF	GLCTLVAML	1
CSARDEVGNTIYF	GLCTLVAML	1
CSVGTGGTNEKLFF	GLCTLVAML	1
CSVGSGGTNEKLFF	GLCTLVAML	1
CASTSGQLAPGELFF	GLCTLVAML	1
CSARDRVGNTIYF	GLCTLVAML	1
CSARLGVGNTIYF	GLCTLVAML	1
CSAPGQEISTEAFF	GLCTLVAML	1
CSVGSSGTNEKLFF	GLCTLVAML	1
CSARIGVGNTIYF	GLCTLVAML	1
CSVGMDGVTNEKLFF	GLCTLVAML	1
CASTSGQTFPGELFF	GLCTLVAML	1
CSARAGVGNTIYF	GLCTLVAML	1
CASSEEGAWNTGELFF	TLNAWVKVV	1
CASSPRGDWEEKAGELFF	KINAWIKVV	1
CSAFSSGTGGVTGELFF	KINAWIKVV	1
CASSLVPQGEEQYF	TLNAWVKVV	1
CASSYRGQSYEQYF	TLNAWVKVV	1
CSARDAGGDYGYTF	TLNAWVKVV	1
CSASRDSYEQYF	KINAWIKVV	1
CASSSVNEQYF	NLVPMVATV	1
CAWVPGTGGTEAFF	NLVPMVATV	1
CASSYWDRITSGNTIYF	NLVPMVATV	1
CASSSVNEQFF	NLVPMVATV	1
CASSIRAAETQYF	GILGFVFTL	1
CASRSGAEAFF	GILGFVFTL	1
CASSIRSAYEQYF	GILGFVFTL	1
CASSTYSQDTQYF	GILGFVFTL	1
CASSTFGANVLTF	GILGFVFTL	1
CASSQGAYGYTF	GILGFVFTL	1
CASSTRSAYEQYF	GILGFVFTL	1
CASSLLLARETQYF	GILGFVFTL	1
CASSIGSYGYTF	GILGFVFTL	1
CASSRRSSDEQYF	GILGFVFTL	1
CASSIRSSTEAFF	GILGFVFTL	1
CASSVRSSYEQYF	GILGFVFTL	1
CASSEDHTGFYEQYF	NLVPMVATV	1
CASSPQTGVGNYGYTF	NLVPMVATV	1
CASSLRGGQSYEQYF	MLYQHLLPL	1
CASSQWDNQPQHF	WMRLLPLL	1
CAISEGAPNTEAFF	FGDHPGHSY	1
CASSGGAVAPSEQFF	GLCTLVAML	1
CASSLLVSGNEQFF	KRWIILGLNK	1
CASSTRQNTEAFF	KRWIILGLNK	1
CASSQGVGNTIYF	KRWIILGLNK	1
CASSRYQTEAFF	KRWIILGLNK	1
CASSGMRGTEAFF	KRWIILGLNK	1
CSARDLAEGTYEQYF	KRWIILGLNK	1
CASSLDVGEQYF	KRWIILGLNK	1
CASSSGMRGTEAFF	KRWIILGLNK	1
CASSLGVNAVEQYF	KRWIILGLNK	1
CASGQSGTAYNEQFF	KRWIILGLNK	1
CSARVGLNNEQFF	KRWIILGLNK	1
CSARAPAGMYPGNQPQHF	KRWIILGLNK	1
CSARDPSRGSGVMDEQFF	KRWIILGLNK	1
CASSDRTVRAYEQYF	KRWIILGLNK	1
CASSRSWLAGGLSTDTQYF	KRWIILGLNK	1
CASSFLQVTEAFF	NLVPMVATV	1
CASSSAHYGYTF	NLVPMVATV	1
CATSDLKVHSGNYGYTF	NLVPMVATV	1
CASSPKLQGAWAEKLFF	NLVPMVATV	1
CASSQDPFAVLNTEAFF	NLVPMVATV	1
CASSFQTGASYGYTF	NLVPMVATV	1
CASKGQGARDGYTF	IPSINVHHY	1
CASRVGTGNLYEQYF	TPRVTGGGAM	1
CASSEVTGTAWGYTF	NLVPMVATV	1
CASSFTWTSGGTTDTQYF	NLVPMVATV	1
CASSHWDRETSGNTIYF	NLVPMVATV	1
CASSLALGVAKNIQYF	TPRVTGGGAM	1
CASSLDPAGQGYEQYF	IPSINVHHY	1
CASSLDSQSSGNTIYF	VLEETSVML	1
CASSLELAMGETQYF	IPSINVHHY	1
CASSLIGQGGPDTQYF	TPRVTGGGAM	1
CASSLQRGRTDTQYF	VLEETSVML	1
CASSLQTGLNTEAFF	TPRVTGGGAM	1
CASSLSPPTYEQYF	TPRVTGGGAM	1
CASSLVGEGLRDEQFF	TPRVTGGGAM	1
CASSPSHGPNEKLFF	IPSINVHHY	1
CASSRELSMGETQYF	IPSINVHHY	1
CASSSSSAPNEKLFF	IPSINVHHY	1
CASSYSGNTEAFF	TPRVTGGGAM	1
CASSYSTGTHLEQYF	NLVPMVATV	1
CASSYSTGVPGELFF	NLVPMVATV	1
CATSDRTGRHEQYF	IPSINVHHY	1
CSVEEGVLYEQYF	IPSINVHHY	1
CAISATGAVTEAFF	RAKFKQLL	1
CASGWGSQPQHF	AVFDRKSDAK	1
CASIPEGGRETQYF	GLCTLVAML	1
CASREGDINTGELFF	IVTDFSVIK	1
CASRTLAGPNTGELFF	RPPIFIRRL	1
CASRTLLGGASEQYF	YVLDHLIVV	1
CASSAAGELETQYF	RPPIFIRRL	1
CASSASAGGYYNEQFF	IVTDFSVIK	1
CASSDGKIAPSEQYF	GLCTLVAML	1
CASSDLNSPLHF	RAKFKQLL	1
CASSEAAGGFYNEQFF	IVTDFSVIK	1
CASSEGEGQGHYGYTF	VSFIEFVGW	1
CASSFSGSLTTEAFF	RAKFKQLL	1
CASSFSPTAQGLEQYF	YPLHEQHGM	1
CASSIGQAYEQYF	FLRGRAYGL	1
CASSLAVLSSYNEQFF	RAKFKQLL	1
CASSLETGSYEQYF	RPPIFIRRL	1
CASSLGVSQETQYF	YVLDHLIVV	1
CASSLNGGHYEQYF	IVTDFSVIK	1
CASSLNRGAREKLFF	AVFDRKSDAK	1
CASSLQGSNQPQHF	YVLDHLIVV	1
CASSLRTLDGYTF	YPLHEQHGM	1
CASSLRTTNEKLFF	YPLHEQHGM	1
CASSLTSAAGELFF	AVFDRKSDAK	1
CASSLVLSSPTYYEQYF	RAKFKQLL	1
CASSLVSSGANVLTF	RAKFKQLL	1
CASSMLGGGRDEQFF	VSFIEFVGW	1
CASSPDGELFF	VSFIEFVGW	1
CASSPFQRSSGNTIYF	YVLDHLIVV	1
CASSPLGHRDTEAFF	VSFIEFVGW	1
CASSQDRLTGGYTF	RPPIFIRRL	1
CASSQETGASGTQYF	RPPIFIRRL	1
CASSQETGSYEQFF	RPPIFIRRL	1
CASSQETGSYEQYF	RPPIFIRRL	1
CASSQETSLYNEQFF	RPPIFIRRL	1
CASSQGFGGGETQYF	YVLDHLIVV	1
CASSQGVGENTEAFF	RAKFKQLL	1
CASSQVRGRGEQYF	RAKFKQLL	1
CASSRTSATGELFF	AVFDRKSDAK	1
CASSSGQAYEQYF	FLRGRAYGL	1
CASSSLRGSNQPQHF	YVLDHLIVV	1
CASSSLTGSGQPQHF	YVLDHLIVV	1
CASSSTEQATYGYTF	RAKFKQLL	1
CASSVGQAYEQYF	FLRGRAYGL	1
CASSVLAGDTQYF	RAKFKQLL	1
CASSWGGGSNYGYTF	IVTDFSVIK	1
CASSWGQGSNYGYTF	IVTDFSVIK	1
CASTGWVTDTQYF	VSFIEFVGW	1
CASTQTSAAGELFF	AVFDRKSDAK	1
CASTVQGRETQYF	YVLDHLIVV	1
CASYWGLAVNEQFF	RPPIFIRRL	1
CSAEIIAEAIYNEQFF	GLCTLVAML	1
CSAPEVRGVWGYTF	YPLHEQHGM	1
CSARDGLGLAYEQYF	IVTDFSVIK	1
CSARGEAITEKLFF	GLCTLVAML	1
CSARGEGGSYNEQFF	VSFIEFVGW	1
CSARQEGGSYNEQFF	VSFIEFVGW	1
CSARSETGNTIYF	GLCTLVAML	1
CSVGADGTNEKLFF	GLCTLVAML	1
CASSLLQGARTEAFF	TPRVTGGGAM	1
CASSLIGVSSYNEQFF	TPRVTGGGAM	1
CASILERGSSYNEQFF	IPSINVHHY	1
CASKLGPAAYEQYF	TPRVTGGGAM	1
CASRVGAGNTEAFF	TPRVTGGGAM	1
CASSCQTGAACGYTF	NLVPMVATV	1
CASSFRDRGHYEQYF	TPRVTGGGAM	1
CASSIPDTEAFF	NLVPMVATV	1
CASSLLPYNALVSGTDTQYF	TPRVTGGGAM	1
CASSLQTGQETQYF	TPRVTGGGAM	1
CASSLRQGIDTGELFF	TPRVTGGGAM	1
CASSLVTGTGKYGYTF	NLVPMVATV	1
CASSPTSGVAGELFF	NLVPMVATV	1
CASSPVGGSMAKNIQYF	VLEETSVML	1
CASSQHDRGFSTEAFF	TPRVTGGGAM	1
CASSRENSNQPQHF	IPSINVHHY	1
CASSSHDRDGGYSPLHF	TPRVTGGGAM	1
CASSSHDRQGQNSPLHF	TPRVTGGGAM	1
CASSSHERQGQNSPLHF	TPRVTGGGAM	1
CASSYDWHEQFF	IPSINVHHY	1
CSATGGGEQYF	IPSINVHHY	1
CAGGTGETSPGELFF	GLCTLVAML	1
CAGPQGRETQYF	YVLDHLIVV	1
CAGRPRLAGGNNEQFF	RAKFKQLL	1
CASKMRGDVYEQYF	RAKFKQLL	1
CASLFTGTSPTDTQYF	RAKFKQLL	1
CASLRGLGTDTQYF	RAKFKQLL	1
CASLYRSSTDTQYF	RPPIFIRRL	1
CASMGGASYNEQFF	YVLDHLIVV	1
CASQRDYTGELFF	YVLDHLIVV	1
CASRAGLAEVSYEQYF	RAKFKQLL	1
CASRGFLGGGQPQHF	YVLDHLIVV	1
CASRGLLGGITEAFF	YVLDHLIVV	1
CASRGMTPPTQYF	VSFIEFVGW	1
CASRPLMGGASEAFF	YVLDHLIVV	1
CASSAASGTDTQYF	FLRGRAYGL	1
CASSDTGGNQPQHF	VSFIEFVGW	1
CASSEILGMNTEAFF	RPPIFIRRL	1
CASSELTGGPYEQYF	YPLHEQHGM	1
CASSFFLPTQREYEQYF	GLCTLVAML	1
CASSFGGGSNYGYTF	IVTDFSVIK	1
CASSFQGSNEKLFF	RAKFKQLL	1
CASSFRLAVKNEQFF	RPPIFIRRL	1
CASSGTHNEQFF	RPPIFIRRL	1
CASSIDGTAYEQYF	GLCTLVAML	1
CASSIQDSLYNEQFF	YPLHEQHGM	1
CASSIVGAHTEAFF	IVTDFSVIK	1
CASSKQGRGTDTQYF	RAKFKQLL	1
CASSLAPSYEQYF	RAKFKQLL	1
CASSLASSGYTGELFF	YPLHEQHGM	1
CASSLEAGVSYEQYF	RPPIFIRRL	1
CASSLEGSYEQYF	RAKFKQLL	1
CASSLGASTDTQYF	RPPIFIRRL	1
CASSLGLENEQFF	GLCTLVAML	1
CASSLGLGVNNEQFF	RAKFKQLL	1
CASSLGTGHNEQFF	RAKFKQLL	1
CASSLGTSFRTDTQYF	YVLDHLIVV	1
CASSLIASGGYNEQFF	RAKFKQLL	1
CASSLLGEKAYEQYF	RAKFKQLL	1
CASSLLGHPSGELFF	RAKFKQLL	1
CASSLLIGANNEQFF	RAKFKQLL	1
CASSLPGTSGISQDTQYF	RAKFKQLL	1
CASSLPRGRDNEQFF	RAKFKQLL	1
CASSLSQGIQNIQYF	RPPIFIRRL	1
CASSLSSATGELFF	AVFDRKSDAK	1
CASSLSSPGNQPQHF	RAKFKQLL	1
CASSLTAPGIQPQHF	RAKFKQLL	1
CASSLTGAGDQPQHF	RAKFKQLL	1
CASSLTGGTYEQYF	RPPIFIRRL	1
CASSLTGPGDQPQHF	RAKFKQLL	1
CASSLTLLGNNEQYF	RAKFKQLL	1
CASSLTSATGELFF	AVFDRKSDAK	1
CASSLYSDTQYF	YVLDHLIVV	1
CASSMLLGGGQPQHF	YVLDHLIVV	1
CASSPGQVTPLHF	RAKFKQLL	1
CASSPGTSGGGDEETQYF	RAKFKQLL	1
CASSPGVTSGRMGEQYF	YVLDHLIVV	1
CASSPITRIVGDTQYF	RAKFKQLL	1
CASSPLIGTSGTEAFF	RAKFKQLL	1
CASSPLPGTTGTDTQYF	YVLDHLIVV	1
CASSPPGPTGRGWYDTF	RAKFKQLL	1
CASSPSKPGDNEQFF	RAKFKQLL	1
CASSPSLVGSADTQYF	YVLDHLIVV	1
CASSPTGTSHTGELFF	VSFIEFVGW	1
CASSPTNPAGDTETQYF	RPPIFIRRL	1
CASSQAGQGNSPLHF	RAKFKQLL	1
CASSQAQGMGNSPLHF	RAKFKQLL	1
CASSQEGTGSYEQYF	AVFDRKSDAK	1
CASSQGALTGQPQHF	YPLHEQHGM	1
CASSQGPGQEHYGYTF	VSFIEFVGW	1
CASSQGSGATNEQFF	VSFIEFVGW	1
CASSQGVLLNEQFF	YVLDHLIVV	1
CASSQIVTSAAQYF	RAKFKQLL	1
CASSQTLAGGGETQYF	YVLDHLIVV	1
CASSQTTSVNTEAFF	RAKFKQLL	1
CASSQVQGTSGGEQYF	RAKFKQLL	1
CASSQVRGGYEQFF	RAKFKQLL	1
CASSRFFPGQGDHAKNIQYF	FLRGRAYGL	1
CASSRGTGEGYEQYF	RAKFKQLL	1
CASSRTDDTEAFF	RAKFKQLL	1
CASSSMVAGEYEQFF	RAKFKQLL	1
CASSSNRDRNTIYF	RAKFKQLL	1
CASSSPGDYTYEQYF	YVLDHLIVV	1
CASSSSLGFGELFF	YVLDHLIVV	1
CASSSTGPGNSPLHF	RAKFKQLL	1
CASSVASGTDTQYF	FLRGRAYGL	1
CASSVELGSGRETQYF	YPLHEQHGM	1
CASSYLGDSTNSPLHF	RAKFKQLL	1
CASTELGDTHNEQFF	IVTDFSVIK	1
CASTGGSGYTF	YVLDHLIVV	1
CASTPGSKLPDTQYF	GLCTLVAML	1
CASTREGLNTGELFF	GLCTLVAML	1
CATATGTGSNTEAFF	RPPIFIRRL	1
CATLAGEGEQFF	RPPIFIRRL	1
CATLISQGSRAGELFF	VSFIEFVGW	1
CATSWTGTYEQYF	YVLDHLIVV	1
CATTQYGTDTQYF	RAKFKQLL	1
CSAPIPPYNEQFF	YVLDHLIVV	1
CSARDRVGNGYTF	GLCTLVAML	1
CSAREIGGRHQPQHF	VSFIEFVGW	1
CSARGAGFSGANVLTF	YVLDHLIVV	1
CSASNQESYGYTF	YVLDHLIVV	1
CSTGTGEGGTQYF	RAKFKQLL	1
CSVEGGPGTAYNEQFF	IVTDFSVIK	1
CSVGGAYEQYF	RPPIFIRRL	1
CSVSAGEEDTQYF	RAKFKQLL	1
CSVVLAPVQEQFF	YVLDHLIVV	1
CSVGAGDYEQYF	RAKFKQLL	1
CASSSLNTEAFF	RAKFKQLL	1
CSGGQGEGEQYF	RAKFKQLL	1
CASSFSTDTQYF	GLCTLVAML	1
CASSPLTDTQYF	RAKFKQLL	1
CASSWTGPSYEQYF	VTEHDTLLY	1
CASSYSSSSYNEQFF	CTELKLSDY	1
CASSFSSLNTGELFF	NLVPMVATV	1
CASSLAGYEQYF	NLVPMVATV	1
CASSYTLPGTVPQRNQPQHF	GILGFVFTL	1
CSVVAGGADTQYF	NLVPMVATV	1
CASSWSGGGARDTQYF	VTEHDTLLY	1
CASSDGQARNTGELFF	TPRVTGGGAM	1
CASSLGAAVREQYF	LPRRSGAAGA	1
CASSPSRNTEAFF	TPRVTGGGAM	1
CASSPTRNTEAFF	TPRVTGGGAM	1
CASSVESGGLSYEQYF	LPRRSGAAGA	1
CASRTGTGAFYEQYF	GILGFVFTL	1
CASSILAVAGNEQFF	GILGFVFTL	1
CASSSHRGEGAFF	GILGFVFTL	1
CASSSRQGNLIDEQFF	TPRVTGGGAM	1
CASSLGRETQYF	LPRRSGAAGA	1
CASSPARNTEAFF	TPRVTGGGAM	1
CASSQGRGPGKYF	GILGFVFTL	1
CAWSGVSYEQYF	GILGFVFTL	1
CAWSVGGGGYTF	GILGFVFTL	1
CSVELASGTYEQYF	GILGFVFTL	1
CASSLLGSNQPQHF	GLCTLVAML	1
CASSQSPGGEQYF	GLCTLVAML	1
CASSVAGGDEQFF	GLCTLVAML	1
CASSAGTPLYYGYTF	GLCTLVAML	1
CASSLLSGTSLRVTGELFF	GLCTLVAML	1
CASSLTDPYEQYF	GLCTLVAML	1
CASSQDFRGGYEQYF	GLCTLVAML	1
CAWSRGAVEQFF	GLCTLVAML	1
CSARDKTGNGYTF	GLCTLVAML	1
CSARGQAITEKLFF	GLCTLVAML	1
CASSLAGGSNQPQHF	GILGFVFTL	1
CASSLAPLSTDTQYF	GILGFVFTL	1
CASSLVSAHEQYF	GILGFVFTL	1
CASSPLDTKQQFF	GILGFVFTL	1
CAWSVLPEAFF	GILGFVFTL	1
CASSARQGIDTGELFF	TPRVTGGGAM	1
CASSTHDRDGGGSAQHF	TPRVTGGGAM	1
CSGRSKGAVNEKLFF	TPRVTGGGAM	1
CASSLAGQGSPYEQYF	LPRRSGAAGA	1
CASSLIGVSSYNEQFF	LPRRSGAAGA	1
CAWSDRGLVDTQYF	LPRRSGAAGA	1
CASSGDHSYEQYF	LPRRSGAAGA	1
CSAISGSGGVGDTQYF	GILGFVFTL	1
CASIDSGAATDTQYF	CTELKLSDY	1
CASSLALRQESREQYF	CTELKLSDY	1
CASSPGTGTYGYTF	VTEHDTLLY	1
CASSVGQGVTYEQYF	VTEHDTLLY	1
CASSPGLAGVYEQYF	CTELKLSDY	1
CASRLAGGGGEQFF	VTEHDTLLY	1
CATSSLSGRVTGELFF	VTEHDTLLY	1
CSVRTGGLGANVLTF	VTEHDTLLY	1
CASSQERGGKWAYEQYF	VTEHDTLLY	1
CASSVGQGKTYEQYF	VTEHDTLLY	1
CATHRAGGFNEQFF	VTEHDTLLY	1
CASSSETTSPLHF	NLVPMVATV	1
CASSGRSTDTQYF	GILGFVFTL	1
CASSMFVGQPQHF	GILGFVFTL	1
CASSYYSNQPQHF	GILGFVFTL	1
CASSVVERAFF	NLVPMVATV	1
CASSLRQGANTGELFF	TPRVTGGGAM	1
CASSLRQGINTGELFF	TPRVTGGGAM	1
CASSSHDLAGVKSEQFF	TPRVTGGGAM	1
CASSAGTGIYDEAFF	TPRVTGGGAM	1
CASSLRGENRDDYEQYF	TPRVTGGGAM	1
CASSLRGESLVNEQFF	TPRVTGGGAM	1
CASSLKGVGQSDEQYF	TPRVTGGGAM	1
CASSLISGRARNEQFF	TPRVTGGGAM	1
CASSFRGEGHPDTQYF	TPRVTGGGAM	1
CASSSHEDRGSSSPLHF	TPRVTGGGAM	1
CASSSHDKQGARSPLHF	TPRVTGGGAM	1
CASSLIGQGLGDEQFF	TPRVTGGGAM	1
CASSSRDRGAYEQYF	TPRVTGGGAM	1
CASSRRGESSYNEQFF	TPRVTGGGAM	1
CASSLRGVSSYNEQFF	TPRVTGGGAM	1
CASSDQSQETQYF	TPRVTGGGAM	1
CASSYSTVNEQFF	TPRVTGGGAM	1
CASRVGGAGNSPLHF	TPRVTGGGAM	1
CASSLSWGGFYNEQFF	TPRVTGGGAM	1
CASRQGAGGNQPQHF	TPRVTGGGAM	1
CASRLGPGQPYEQYF	TPRVTGGGAM	1
CASSLGSSGTRQYF	TPRVTGGGAM	1
CASSLLGLQGSYNEQFF	TPRVTGGGAM	1
CASSLGSSGNEQFF	TPRVTGGGAM	1
CASSLGAGNYGYTF	TPRVTGGGAM	1
CASSLSTSSRNYGYTF	TPRVTGGGAM	1
CASRTGAANIYEQYF	TPRVTGGGAM	1
CASSLSPSTGNYGYTF	TPRVTGGGAM	1
CASSLGPGNYEQYF	TPRVTGGGAM	1
CASNTGGANTDTQYF	TPRVTGGGAM	1
CASSLGGSPNYGYTF	TPRVTGGGAM	1
CASRLGAAGSQPQHF	TPRVTGGGAM	1
CASSVAGSATGELFF	NLVPMVATV	1
CASSVGSEAYTYEQYF	NLVPMVATV	1
CASSVGAGVFTDTQYF	NLVPMVATV	1
CASSGVGGTDTQYF	NLVPMVATV	1
CASFRGHEQFF	NLVPMVATV	1
CASSLGLAATYNEQFF	NLVPMVATV	1
CASSWAGGPRDEQYF	NLVPMVATV	1
CASSTSLLAGNNEQFF	NLVPMVATV	1
CASSLMGPGQPQHF	NLVPMVATV	1
CASSLRQGEGMGEQFF	NLVPMVATV	1
CASMNDGATYEQYF	NLVPMVATV	1
CASRSGTYDNSPLHF	NLVPMVATV	1
CASRALRGDNEQFF	NLVPMVATV	1
CASSDPDRAVTEAFF	NLVPMVATV	1
CASSLDRDRGRPEAFF	NLVPMVATV	1
CASSLAERSYEQYF	NLVPMVATV	1
CASSFGQAWETQYF	NLVPMVATV	1
CASSFGQAWYEQYF	NLVPMVATV	1
CASSLSDRGGDEQFF	NLVPMVATV	1
CASRLGLGYEQYF	NLVPMVATV	1
CASSFYSSGRNSYF	NLVPMVATV	1
CASSLRPLDMNTEAFF	NLVPMVATV	1
CASSLTSEQFF	NLVPMVATV	1
CASSPGTLKETQYF	NLVPMVATV	1
CASSVVNEQFF	NLVPMVATV	1
CASSLTNEQFF	NLVPMVATV	1
CASSPLTGTGHYGYTF	NLVPMVATV	1
CASREGEYYGYTF	NLVPMVATV	1
CASSYQTGASYGYTF	NLVPMVATV	1
CASSYSTGIGGGYTF	NLVPMVATV	1
CASTPQTGTGTYGYTF	NLVPMVATV	1
CSVGQGEDGPQHF	RAKFKQLL	1
CSAGTGEGGEQFF	RAKFKQLL	1
CSSGTGDGGEQFF	RAKFKQLL	1
CSVGFGEGYEQYF	RAKFKQLL	1
CSVGQGGNYGYTF	RAKFKQLL	1
CSVKGGFPYNEQFF	RAKFKQLL	1
CSTGQGPYEQYF	RAKFKQLL	1
CSVGGVSSGVYNEQFF	RAKFKQLL	1
CSVGGGTEAFF	RAKFKQLL	1
CSGGQGEGEQFF	RAKFKQLL	1
CSVGTGDNSPLHF	RAKFKQLL	1
CSVGSGEDNEQFF	RAKFKQLL	1
CSAGQGEGEQYF	RAKFKQLL	1
CSVGAGEGYEQYF	RAKFKQLL	1
CSVGAGEGGPQHF	RAKFKQLL	1
CASSLDGRQVNQPQHF	RAKFKQLL	1
CASSPSGANVLTF	RAKFKQLL	1
CASSSPNTEAFF	RAKFKQLL	1
CASSSLDTEAFF	RAKFKQLL	1
CASSLLGGGYAYEQYF	RAKFKQLL	1
CASSLLTGHEQFF	RAKFKQLL	1
CASSLIPGDYYGYTF	RAKFKQLL	1
CSARGGTGNGYTF	GLCTLVAML	1
CSARDRTGNTIYF	GLCTLVAML	1
CSARSEVGNTIYF	GLCTLVAML	1
CSARVEPGNGYTF	GLCTLVAML	1
CSAHRTENTEAFF	GLCTLVAML	1
CSVGGTFYGYTF	GLCTLVAML	1
CSVPGTDYNEQFF	GLCTLVAML	1
CSVDLANTEAFF	GLCTLVAML	1
CSVGQGGTNEKLFF	GLCTLVAML	1
CSVGSGGTNERLFF	GLCTLVAML	1
CSVEASGGLFNEQFF	GLCTLVAML	1
CSATDSMNTEAFF	GLCTLVAML	1
CSVPGQVLETQYF	GLCTLVAML	1
CSVEYSPTLYNEQFF	GLCTLVAML	1
CSVPSLLNTEAFF	GLCTLVAML	1
CASSPSAAAYEQYF	FLRGRAYGL	1
CASSPRTLGTEAFF	FLRGRAYGL	1
CASSTGQAYEQYF	FLRGRAYGL	1
CASRRQRTDTEAFF	TPRVTGGGAM	1
CASSQRLAGAHEQYF	TPRVTGGGAM	1
CSVIGGFGTGELFF	TPRVTGGGAM	1
CSVEERVRGGEQYF	TPRVTGGGAM	1
CSVEERVWGGEQYF	TPRVTGGGAM	1
CASSYVIYEQYF	TPRVTGGGAM	1
CASSQKGLDTEAFF	TPRVTGGGAM	1
CASGQKGLDTEAFF	TPRVTGGGAM	1
CASSYSSGELFF	TPRVTGGGAM	1
CATSDDRDTGELFF	TPRVTGGGAM	1
CASNQETQYF	FLRGRAYGL	1
CASSWGPEAFF	FLRGRAYGL	1
CASSQAGFNEQFF	FLRGRAYGL	1
CSARDRGAANTGELFF	RAKFKQLL	1
CSARDRGAENTGELFF	RAKFKQLL	1
CSAKDRGAENTGELFF	RAKFKQLL	1
CSARDREGGNSPLHF	RAKFKQLL	1
CASSYSGGVFEQFF	RAKFKQLL	1
CASSLTAGNNYGYTF	RAKFKQLL	1
CASSLTAGNNCGYTF	RAKFKQLL	1
CASSWLAGTREEQYF	RAKFKQLL	1
CASSGSGLVNTGELFF	RAKFKQLL	1
CASSSTRTGDGQPQHF	RAKFKQLL	1
CASSFGQGEGYEQYF	RAKFKQLL	1
CASSPGTGEGYEQYF	RAKFKQLL	1
CASSQEGQLSYEQYF	RAKFKQLL	1
CASSPLAGVGETQYF	RAKFKQLL	1
CASSLIRGTGELFF	RAKFKQLL	1
CASSYPRGGEGSPLHF	RAKFKQLL	1
CASSYPWGGEGSPLHF	RAKFKQLL	1
CASNYPRGGEGSPLHF	RAKFKQLL	1
CASSPGGRQGDYNEQFF	RAKFKQLL	1
CASSLLAGQETQYF	RAKFKQLL	1
CASSLSAGQETQYF	RAKFKQLL	1
CASSELAGVGETQYF	RAKFKQLL	1
CASSSSSGASYNEQFF	RAKFKQLL	1
CASSEQSGANVLTF	RAKFKQLL	1
CASSVSTGEAYGYTF	GPGHKARVL	1
CASSFGGATGPGELFF	GPGHKARVL	1
CASSASTGEAYGYTF	GPGHKARVL	1
CASSVAAGLSHEQFF	GPGHKARVL	1
CSVVETVGETQYF	GPGHKARVL	1
CSVDLGVAGGPNTGELFF	GPGHKARVL	1
CSVGQNSANTGELFF	GPGHKARVL	1
CSVEDLGLAGATEQFF	GPGHKARVL	1
CASGYRDRGVAFF	GPGHKARVL	1
CASSPSGYNNEQFF	GPGHKARVL	1
CASSSTGYVNEQYF	GPGHKARVL	1
CASSLAGDGANVLTF	GPGHKARVL	1
CASSLRGETQYF	GPGHKARVL	1
CASSLNTGVKNIQYF	GPGHKARVL	1
CASFRTGTSETQYF	GPGHKARVL	1
CASSFRGQQNNEQFF	GPGHKARVL	1
CASSLETGTEAFF	GPGHKARVL	1
CASSLGLEPQHF	GPGHKARVL	1
CAQPVVYSYEQYF	GPGHKARVL	1
CASSLGDSWNSPLHF	GPGHKARVL	1
CASSGQDSTQYF	GPGHKARVL	1
CASSQDEPSEQYF	GPGHKARVL	1
CASSQVLAPIQYF	GPGHKARVL	1
CASSQAAASGPYEQYF	GPGHKARVL	1
CASSQDGVYTQYF	GPGHKARVL	1
CASSPTGGPGELFF	GPGHKARVL	1
CASSQAERKETQYF	GPGHKARVL	1
CASSQAATGSYEQYF	GPGHKARVL	1
CASRDYEQYF	GPGHKARVL	1
CATRDYEQYF	GPGHKARVL	1
CASSIAEREAFF	GPGHKARVL	1
CASSILAGLNEQYF	GPGHKARVL	1
CASTTGQINYGYTF	GPGHKARVL	1
CASSIPPSGEQFF	GPGHKARVL	1
CASSAFAGTGELFF	GPGHKARVL	1
CASSIETSPGDTQYF	GPGHKARVL	1
CACLLPYEQYF	GPGHKARVL	1
CAWNRGMNTEAFF	GPGHKARVL	1
CALAVPYEQYF	GPGHKARVL	1
CASSLEAGATYNEQFF	GPGHKARVL	1
CASSLESGSSYNEQFF	GPGHKARVL	1
CASSSRTGASGNTIYF	GPGHKARVL	1
CASSLGTSGSYEQYF	GPGHKARVL	1
CASSLIYRGGDGYTF	GPGHKARVL	1
CASSPSGTPYEQYF	GPGHKARVL	1
CASSPSGTPYERYF	GPGHKARVL	1
CATSRLDITPNSPLHF	GPGHKARVL	1
CATSREEPIQPGEQFF	GPGHKARVL	1
CATRSTDTQYF	GPGHKARVL	1
CATSRVGQWNTEAFF	GPGHKARVL	1
CATSSRGGETQYF	GPGHKARVL	1
CATGRLAGETQYF	GPGHKARVL	1
CATSREPGSIVNEQFF	GPGHKARVL	1
CASSFDVEQFF	SLYNTVATL	1
CASSPRTEKYTQYF	SLYNTVATL	1
CASLSGGAFYHTGELFF	SLYNTVATL	1
CASSYSTHYSLESDTQYF	SLYNTVATL	1
CASSEARWVAGVWTGELFF	SLYNTVATL	1
CASRPYSGRAGAYTGELFF	SLYNTVATL	1
CASSYRGLKEQYF	SLYNTVATL	1
CASSYVTPDYGYTF	SLYNTVATL	1
CASSLGRGSGANVLTF	SLYNTVATL	1
CASSGVGYQPQHF	SLYNTVATL	1
CASSIFPGGGYGYTF	SLYNTVATL	1
CASSMIGHSNQPQHF	SLYNTVATL	1
CASSIDGAGNQPQHF	SLYNTVATL	1
CATSGTDRGGGETQYF	SLYNTVATL	1
CASSEALLGRANYGYTF	NLVPMVATV	1
CASSPLTGTGVYGYTF	NLVPMVATV	1
CASSSSFPGGGNEQFF	NLVPMVATV	1
CASSYATGASYGYTF	NLVPMVATV	1
CASTLLGGAGYNEQFF	NLVPMVATV	1
CSARDQVRANYGYTF	NLVPMVATV	1
CASRRLAGSTDTQYF	NLVPMVATV	1
CASSYVGLGSPLHF	NLVPMVATV	1
CSVMLANQETQYF	CLGGLLTMV	1
CSVGNSGYQETQYF	CLGGLLTMV	1
CSASPRGGEQYF	CLGGLLTMV	1
CASSLGQGVLSDTQYF	CLGGLLTMV	1
CSVGGYGTNEKLFF	GLCTLVAML	1
CASSPGQVLPGEQYF	GLCTLVAML	1
CSVAGTGDLNQPQHF	GLCTLVAML	1
CASSLQGFLLSYEQYF	GLCTLVAML	1
CASSLVDGDIQYF	GLCTLVAML	1
CASSEGRVAPGEQYF	GLCTLVAML	1
CASSIVGGNEQFF	GILGFVFTL	1
CASSMRSTGELFF	GILGFVFTL	1
CASSIRSAWAQYF	GILGFVFTL	1
CASSQRSTGELFF	GILGFVFTL	1
CASSFDGVYEQYF	GILGFVFTL	1
CASSSHAGGNTEAFF	GILGFVFTL	1
CASSIVGGNEQFF	GLCTLVAML	1
CASSMRSTGELFF	GLCTLVAML	1
CASSIRSAWAQYF	GLCTLVAML	1
CASSSHAGGNTEAFF	GLCTLVAML	1
CASSQRSTGELFF	GLCTLVAML	1
CASSLRSTGELFF	GLCTLVAML	1
CASSIRSSYEQYF	GLCTLVAML	1
CASSWLSNQPQHF	GLCTLVAML	1
CASSIRSTGELFF	GLCTLVAML	1
CASSFDGVYEQYF	GLCTLVAML	1
CASSIVGGNEQFF	YVLDHLIVV	1
CASSIRSAWAQYF	YVLDHLIVV	1
CASSQRSTGELFF	YVLDHLIVV	1
CASSMRSTGELFF	YVLDHLIVV	1
CASSSHAGGNTEAFF	YVLDHLIVV	1
CASSNRAGNEQFF	YVLDHLIVV	1
CASSIRSTGELFF	YVLDHLIVV	1
CASSIRSAYEQYF	YVLDHLIVV	1
CASSFDGVYEQYF	YVLDHLIVV	1
CASSTRSSYEQYF	YVLDHLIVV	1
CASSMRSADTQYF	GILGFVFTL	1
CASSVRASDEQYF	GILGFVFTL	1
CASSPSSVADTQYF	GILGFVFTL	1
CASSSRAAYEQYF	GILGFVFTL	1
CASSIRASNEQFF	GILGFVFTL	1
CASSGRSADTQYF	GILGFVFTL	1
CASSTRATGELFF	GILGFVFTL	1
CASSIRGSETQYF	GILGFVFTL	1
CASSPRSNQPQHF	GILGFVFTL	1
CAITGGGEQFF	GILGFVFTL	1
CASSTHSGGNNEQFF	GILGFVFTL	1
CASSRRSGGDEQFF	GILGFVFTL	1
CASSARSSYEQYF	GILGFVFTL	1
CASSDRGGGDEQFF	GILGFVFTL	1
CASSVRASYEQYF	GILGFVFTL	1
CASSPSGPWPQYF	GILGFVFTL	1
CASSIRSTGELFF	GILGFVFTL	1
CASSTVSLDTQYF	GILGFVFTL	1
CASSLRSSYEQYF	GILGFVFTL	1
CASSARSADTQYF	GILGFVFTL	1
CASSIVSQETQYF	GILGFVFTL	1
CASSIRSGGEQYF	GILGFVFTL	1
CASSATSIYEQFF	GILGFVFTL	1
CASSTRSSYEQYF	GILGFVFTL	1
CASATGTYGYTF	GILGFVFTL	1
CASSIRSSHEQYF	GILGFVFTL	1
CASSPTGVGEQFF	GILGFVFTL	1
CASSIRASYEQYF	GILGFVFTL	1
CASSIYSGPYNEQFF	GILGFVFTL	1
CASSIFHTDTQYF	GILGFVFTL	1
CASSIRSGETQYF	GILGFVFTL	1
CASSVRSAYEQYF	GILGFVFTL	1
CASSIHSGGAVEQFF	GILGFVFTL	1
CASSRPGTSAFPYEQYF	GILGFVFTL	1
CASSVRSTGELFF	GILGFVFTL	1
CASSIRSEDTQYF	GILGFVFTL	1
CASSIRSTDTQYF	GILGFVFTL	1
CASSPVGIDEQYF	GILGFVFTL	1
CASSQRSTDTQYF	GILGFVFTL	1
CASSMFGGNEQFF	GILGFVFTL	1
CASSKRSTGELFF	GILGFVFTL	1
CASSIGIYGYTF	GILGFVFTL	1
CASSYRSTLEQFF	GILGFVFTL	1
CASSTRSTGELFF	GILGFVFTL	1
CAWSGLGPSYNEQFF	GILGFVFTL	1
CASSIRSGVEQFF	GILGFVFTL	1
CASSTSAANQPQHF	GILGFVFTL	1
CASTLAGVGYEQFF	GILGFVFTL	1
CASSTGNYGYTF	GILGFVFTL	1
CASSTGFYGYTF	GILGFVFTL	1
CASSIRSAHEQFF	GILGFVFTL	1
CASAAGTYGYTF	GILGFVFTL	1
CASSQEDLTSGTNEQFF	GILGFVFTL	1
CASSIRSSNEQFF	GILGFVFTL	1
CASSQFPLTGGNTEAFF	GILGFVFTL	1
CASSTGIYGYTF	GILGFVFTL	1
CASSMGSYGYTF	GILGFVFTL	1
CASTTAVYGYTF	GILGFVFTL	1
CASSKANGGSNQPQHF	GILGFVFTL	1
CASSIYSIEEQFF	GILGFVFTL	1
CASSPGKLDSEETQYF	TPRVTGGGAM	1
CASSLGPNNYYGYTF	TPRVTGGGAM	1
CASGLGSSPMFNEQFF	TPRVTGGGAM	1
CASSLGPASYEQYF	TPRVTGGGAM	1
CASSTQDLQGARSPLHF	TPRVTGGGAM	1
CASSLGAAGRELFF	TPRVTGGGAM	1
CASSPRDSQPYGYTF	TPRVTGGGAM	1
CASSKEDREKETQYF	TPRVTGGGAM	1
CASSLGSANTDTQYF	TPRVTGGGAM	1
CSGGALGQDFGGYTF	TPRVTGGGAM	1
CASSLSYSTLSYEQYF	TPRVTGGGAM	1
CATAEGAGELFF	TPRVTGGGAM	1
CASSLSHSTGNYGYTF	TPRVTGGGAM	1
CASRLGLAGGINEQFF	TPRVTGGGAM	1
CASTLGSAGPQFNEQFF	TPRVTGGGAM	1
CASSLSPSTGRVEQYF	TPRVTGGGAM	1
CASSLGSTPYEQYF	TPRVTGGGAM	1
CASSYSPPIPGQGIDEQYF	YSEHPTFTSQY	1
CASSSQRESSDTQYF	YSEHPTFTSQY	1
CASSQWERDPQYF	YSEHPTFTSQY	1
CASSQVLRVLSYNEQFF	YSEHPTFTSQY	1
CATSSRDTSSDEQFF	YSEHPTFTSQY	1
CASSLLRDSPTDTQYF	YSEHPTFTSQY	1
CASTRADTGELFF	YSEHPTFTSQY	1
CATSSPMGSTDTQYF	YSEHPTFTSQY	1
CATAQNRLQETQYF	YSEHPTFTSQY	1
CSVEGLAGTGELFF	YSEHPTFTSQY	1
CATSRPTSGSDEQFF	YSEHPTFTSQY	1
CAISEWDIHSSGNTIYF	NLVPMVATV	1
CASSPLFGREPDGETQYF	NLVPMVATV	1
CATSRPLDSTDTQYF	YSEHPTFTSQY	1
CASSPGLGAEAFF	YSEHPTFTSQY	1
CSVWGETQYF	YSEHPTFTSQY	1
CAISESGSPEQYF	YSEHPTFTSQY	1
CASSRLAGGTGELFF	QIKVRVKMV	1
CSVEESGLAGNTGELFF	QIKVRVKMV	1
CASSLGVSEPQHF	QIKVRVKMV	1
CASSSGTSGYEQYF	QIKVRVKMV	1
CASSLSRGAYEQYF	QIKVRVKMV	1
CASSPGGQGGQPQHF	QIKVRVKMV	1
CSVGRDRDHGYTF	QIKVRVKMV	1
CSGVVGRGAYNEQFF	QIKVRVKMV	1
CASSYGPVETEAFF	QIKVRVKMV	1
CASSSREVTGELFF	QIKVRVKMV	1
CASKWTSGGPNTGELFF	QIKVRVKMV	1
CSVGQGATEQYF	VLEETSVML	1
CASSVRQEPYNEQFF	VLEETSVML	1
CASSDTPQPFSSGYTF	EPLPQGQLTAY	1
CASSDVAPAPFYGYTF	EPLPQGQLTAY	1
CASSIDLRGYQNIQYF	EPLPQGQLTAY	1
CASSQDGAGGLGEQFF	GLCTLVAML	1
CSARSRVGNTIYF	GLCTLVAML	1
CASSLPSGGTNNEQFF	RPPIFIRRL	1
CSARDQGEWGIKETQYF	RPPIFIRRL	1
CASSLMTGELFF	HPVGEADYFEY	1
CASSPSGTSPKNEQFF	HPVGEADYFEY	1
CASSLTGGYNEQFF	HPVGEADYFEY	1
CASSIISVDGYTF	GILGFVFTL	1
CASSGRSNTEAFF	GILGFVFTL	1
CASSITSSYNEQFF	GILGFVFTL	1
CASSARATDTQYF	GILGFVFTL	1
CASSSETELLYYGYTF	NLVPMVATV	1
CASSQQTGTIGGYTF	NLVPMVATV	1
CASSFQGFTEAFF	NLVPMVATV	1
CASSFTLGTGGVEQYF	NLVPMVATV	1
CSARGQDIYEQYF	NLVPMVATV	1
CASGLTGFMDEQYF	NLVPMVATV	1
CASSVDVAGGYNEQFF	NLVPMVATV	1
CASSQALPYEQYF	NLVPMVATV	1
CASSITLGTGGVEQYF	NLVPMVATV	1
CASSQGFGANVLTF	AAFKRSCLK	1
CASVSGQGVSPLHF	AAFKRSCLK	1
CATSRDGAGLVNQPQHF	AAFKRSCLK	1
CASSQDPGSSYNEQFF	AAFKRSCLK	1
CASSPNPQGANMDTQYF	RSGGFSFGK	1
CASSELPAGGTNEQFF	RLARLALVL	1
CASSFFSNTGELFF	RLARLALVL	1
CASSFLTDTQYF	RLARLALVL	1
CASSYMGPEAFF	RLARLALVL	1
CASMDLAFKQYF	RLARLALVL	1
CASSQVSGYEQYF	RLARLALVL	1
CASSPQGDNEQFF	RLARLALVL	1
CASSQGGDEQFF	ALYGFVPVL	1
CASSQDPLLEGYSYNEQFF	NLNCCSVPV	1
CASSGELRGAEKLFF	AVGSYVYSV	1
CASSYGGEQPQHF	NLNCCSVPV	1
CASSNGYGNQPQHF	ALYGFVPVL	1
CASSVEGVADEQYF	AVGSYVYSV	1
CASSDLQGGGPGEQYF	ALYGFVPVL	1
CASSVEGVADTQYF	AVGSYVYSV	1
CASSSTGALYEQYF	KLSHQLVLL	1
CASTIALGYEQYF	NLNCCSVPV	1
CASSSGGGNEQFF	NLNCCSVPV	1
CASSPSLQVAQHF	ALYGFVPVL	1
CATSDPGTTNTGELFF	ALYGFVPVL	1
CASSLGGGAYEQYF	ALYGFVPVL	1
CSASPGYNEQFF	VVMSWAPPV	1
CASSLAGESSYNEQFF	VVMSWAPPV	1
CASSLGDPNTEAFF	KLFEFLVYGV	1
CASSLGGYSPLHF	VVMSWAPPV	1
CASSTQGQPQHF	VVMSWAPPV	1
CASSLGGSYTF	VVMSWAPPV	1
CASSPWTPTTDTQYF	VVMSWAPPV	1
CASNFPNISEGTCSNQPQHF	VVMSWAPPV	1
CASSSGGGNEQFF	ALTPVVVTL	1
CASSAQGFGELFF	ALTPVVVTL	1
CASSEGRETQYF	ALTPVVVTL	1
CASSIGQGPYEQYF	ALTPVVVTL	1
CASSLGGRRYEQYF	ALTPVVVTL	1
CASSLGQKEQYF	ALTPVVVTL	1
CASSIRSVAEAFF	GILGFVFTL	1
CASSVSATGELFF	GILGFVFTL	1
CASSHRGTGELFF	GILGFVFTL	1
CASSLRSTGELFF	GILGFVFTL	1
CASSDRSSQPQHF	GILGFVFTL	1
CASSDPLAGGNEQYF	CINGVCWTV	1
CSAWTGSATEAFF	CINGVCWTV	1
CASSEVVTAFSYEQYF	CINGVCWTV	1
CASISSNQPQHF	CINGVCWTV	1
CATSDAPGTGIPYEQYF	CINGVCWTV	1
CASSLGTQTYEQYF	CINGVCWTV	1
CASSPGTSDPANYGYTF	CINGVCWTV	1
CASSLSGTGELFF	CINGVCWTV	1
CASSSGQGNIQYF	CINGVCWTV	1
CASSFDSGAYEQYF	ARMILMTHF	1
CASSTKQGWYEQYF	ARMILMTHF	1
CASRLGASSYNEQFF	ARMILMTHF	1
CASSYGQAYQPQHF	ARMILMTHF	1
CASSYSNLPVFSPNQPQHF	ARMILMTHF	1
CASSIVGHMNTEAFF	ARMILMTHF	1
CASSLYGGSNTGELFF	ARMILMTHF	1
CASSEGSHSNQPQHF	ARMILMTHF	1
CSASITGTEQYF	ARMILMTHF	1
CASSIVGHLNTEAFF	ARMILMTHF	1
CASSLDASSASYEQYF	ARMILMTHF	1
CASREDGGGYEQYF	ARMILMTHF	1
CASSFDGQGYEQYF	ARMILMTHF	1
CASSLKGQVGEQYF	ARMILMTHF	1
CASTSQSELFF	CINGVCWTV	1
CASSRFLGSGGAAEQFF	CINGVCWTV	1
CASSYSAGTLDYGYTF	CINGVCWTV	1
CAISESTAGSQPQHF	ATDALMTGY	1
CAGNNRDSSTDTQYF	ATDALMTGY	1
CSARPIDSSNQPQHF	ATDALMTGY	1
CASSGTRQISGTEAFF	ATDALMTGY	1
CASSVDEGNTGELFF	CINGVCWTV	1
CASSLSGGNQETQYF	CINGVCWTV	1
CATSEPAGLAGGNNEQFF	CINGVCWTV	1
CASSLAGTSTEQFF	CINGVCWTV	1
CASSLEGLVAVETQYF	CINGVCWTV	1
CASSSLADFYQPQHF	CINGVCWTV	1
CASSLGTSGGFTDTQYF	CINGVCWTV	1
CASSISSTGELFF	GILGFVFTL	1
CASSGRAAGELFF	GILGFVFTL	1
CASSIHSTDTQYF	GILGFVFTL	1
CASSVDGGGLDEQFF	GILGFVFTL	1
CASSTSGGGTEAFF	GILGFVFTL	1
CASSGRSTGELFF	GILGFVFTL	1
CSARVGVGNTIYF	GLCTLVAML	1
CSARTGVGNTIYF	GLCTLVAML	1
CASRPDSDYGYTF	GLCTLVAML	1
CASSQNQDMGTEAFF	GLCTLVAML	1
CSAWDREVVGTEAFF	GLCTLVAML	1
CSVEDGYEQYF	CVNGSCFTV	1
CASSNSEGSGANVLTF	CVNGSCFTV	1
CASSPLYVALREQYF	CVNGSCFTV	1
CASTSGNTGELFF	CVNGSCFTV	1
CASSPTVAGEQFF	CVNGSCFTV	1
CASNPLSAGNQPQHF	CVNGSCFTV	1
CASSEDQGLTATYEQYF	CVNGSCFTV	1
CSARVPDSNTGELFF	CVNGSCFTV	1
CASSSPRTGYNYGYTF	CVNGSCFTV	1
CASSPTSGGNNEQFF	CVNGSCFTV	1
CASSQDRGVLVLIDQPQHF	CVNGSCFTV	1
CSARTEGAEAFF	CVNGSCFTV	1
CASSYWTGSSAETQYF	CVNGSCFTV	1
CSARTSGDFGEQFF	CVNGSCFTV	1
CASSQGGQGAPYEQYF	CINGVCWTV	1
CASSQAENTEAFF	CINGVCWTV	1
CASSLLGLAGVGELFF	CINGVCWTV	1
CASSLTGTGFKQFF	CINGVCWTV	1
CASSLTLAGGIGTDTQYF	CINGVCWTV	1
CASSLGTGAPYEQYF	CINGVCWTV	1
CATSNLDSFGGYTF	CINGVCWTV	1
CASSLSTGAPYEQYF	CINGVCWTV	1
CASSLGPPPDNEQFF	CINGVCWTV	1
CATSPGQGFYNEQFF	CINGVCWTV	1
CASRLLAGAYEQYF	CINGVCWTV	1
CASSQESGTEAFF	CINGVCWTV	1
CASNRENEKLFF	CINGVCWTV	1
CASSQEKGTEAFF	CINGVCWTV	1
CASTTGSSEKLFF	CINGVCWTV	1
CATSTTFQTDYAEPYGYTF	CINGVCWTV	1
CASSRPVGLFNYGYTF	CINGVCWTV	1
CASSQAQSGTAPYEQYF	CINGVCWTV	1
CASSLTLGLAGVETQYF	CINGVCWTV	1
CASSSPSGRPTLYNEQFF	CINGVCWTV	1
CASSYYSGGTETQYF	NEGVKAAW	1
CASSPTDSPYGQFF	NEGVKAAW	1
CASSLAGPGGEQFF	NEGVKAAW	1
CATRGQGGHTEAFF	NEGVKAAW	1
CASSIFGEQYF	NEGVKAAW	1
CASGPTAGGTDTQYF	NEGVKAAW	1
CSVAPGQGKNHSNQPQHF	NEGVKAAW	1
CASSVVRGVYEQYF	NEGVKAAW	1
CASSSGRSNQPQHF	NEGVKAAW	1
CASSIVQGPYNEQFF	NEGVKAAW	1
CASHQTGTGSNQPQHF	NEGVKAAW	1
CASSLGQLEQYF	NEGVKAAW	1
CASSLGQIEQYF	NEGVKAAW	1
CASSLGQLEAFF	NEGVKAAW	1
CASTERGVLTDTQYF	NEGVKAAW	1
CASSVQLPLGVPYEQYF	NEGVKAAW	1
CANSRGGSDNEQFF	NEGVKAAW	1
CASSIVAGSYNEQFF	NEGVKAAW	1
CASSIVTGPYNEQFF	NEGVKAAW	1
CASSISGLNTDTQYF	NEGVKAAW	1
CASSFWTGHADTQYF	NEGVKAAW	1
CASSLRGVWTDTQYF	NEGVKAAW	1
CASSIVGEQFF	NEGVKAAW	1
CASSLLAGAADTQYF	NEGVKAAW	1
CASRLQGGNTEAFF	NEGVKAAW	1
CASSLAPGPYSGANVLTF	NEGVKAAW	1
CSARGGRDVGELFF	NEGVKAAW	1
CASNPSWAYSNQPQHF	TPQDLNTML	1
CASSLPGELFF	TPQDLNTML	1
CASKAGGSYNEQFF	TPQDLNTML	1
CASSLGYTEAFF	TPQDLNTML	1
CASSVASGTSGGGQFF	TPQDLNTML	1
CASSLAFGTGAGELFF	TPQDLNTML	1
CASSVLGGYTF	TPQDLNTML	1
CASRQGPYEQYF	TPQDLNTML	1
CASSVNSGFEAFF	TPQDLNTML	1
CASSLSSLGEAFF	TPQDLNTML	1
CASSLRTPGQALRNEKLFF	TPQDLNTML	1
CASSLGQLREAFF	TPQDLNTML	1
CASSFGAINEAFF	TPQDLNTML	1
CASSQGSLSEAFF	TPQDLNTML	1
CASSLGGLNTIYF	TPQDLNTML	1
CASSSRRRGMNTEAFF	TPQDLNTML	1
CASSFTGTSGPQETQYF	TPQDLNTML	1
CASSLGLNTIYF	TPQDLNTML	1
CASSFSKNTEAFF	TPQDLNTML	1
CASSQEGGGGGQPQHF	TPQDLNTML	1
CASSLGLSGRWAFF	TPQDLNTML	1
CATREPNTGELFF	TPQDLNTML	1
CAISERAIRGTSGLTDTQYF	TQGYFPDWQNY	1
CASSQAAGGRAFF	TQGYFPDWQNY	1
CASSLDSGFLEQYF	GLNKIVRMY	1
CAISESGGRVDEQYF	GLNKIVRMY	1
CASSLQGAPEQFF	GLNKIVRMY	1
CASSLYGEYEQYF	KRWIILGLNK	1
CASSQGTTDTQYF	KRWIILGLNK	1
CASRPGQGGYEQYF	ISPRTLNAW	1
CASSLAQGWKTQYF	ISPRTLNAW	1
CASRTQRWETQYF	QASQEVKNW	1
CASSQGPGERAGFNYEQYF	QASQEVKNW	1
CASSLGYGYTF	QASQEVKNW	1
CASSKGRYNEQFF	QASQEVKNW	1
CASPHPDRPNYGYTF	KAFSPEVIPMF	1
CASGGEFYGYTF	KAFSPEVIPMF	1
CASSIAGGGEDTQYF	KRWIILGLNK	1
CSARGWVSNNQETQYF	KRWIILGLNK	1
CASSFIPGQGTHYSNQPQHF	FLKEKGGL	1
CAIRPFLGQDDNYGYTF	FLKEKGGL	1
CASSLRGTGELFF	FLKEKGGL	1
CAIGGHDYGYTF	KAFSPEVIPMF	1
CASSSLVNTGELFF	KAFSPEVIPMF	1
CALTGGDYGYTF	KAFSPEVIPMF	1
CSARGWVSNNRETQYF	KAFSPEVIPMF	1
CSAREKGSQETQYF	KAFSPEVIPMF	1
CASSELGARVYEQYF	FLKEKGGL	1
CASSESSREVSYNSPLHF	FLKEKGGL	1
CASTGGRGSPLHF	EIYKRWII	1
CASSQDRIHTEAFF	ISPRTLNAW	1
CASSLGGGYTF	KAFSPEVIPMF	1
CASEDFKNIQYF	KAFSPEVIPMF	1
CASSPGQTNYGYTF	KAFSPEVIPMF	1
CASYNFGQYGYTF	KAFSPEVIPMF	1
CASSPMDLLDEQYF	KAFSPEVIPMF	1
CASSELGATIYEQYF	FLKEKGGL	1
CASSQEMNRVVGNEQFF	FLKEKGGL	1
CASRGGSGELFF	KAFSPEVIPMF	1
CASSGFRDRVNEQYF	KAFSPEVIPMF	1
CASSVVGDSRETQYF	EIYKRWII	1
CASSTLGDSREKLFF	EIYKRWII	1
CASSEPPGVRGEAFF	EIYKRWII	1
CAGSQEFLNRRYF	EIYKRWII	1
CASSLSGSGWQETQYF	EIYKRWII	1
CASSEAGGTEAFF	GLNKIVRMY	1
CASSVEGTILTDTQYF	GLNKIVRMY	1
CASSVEGTIHTDTQYF	GLNKIVRMY	1
CASSLQQTLGAFF	GLNKIVRMY	1
CASSPQQTLGAFF	GLNKIVRMY	1
CASSDNGGDRSPGELFF	GLNKIVRMY	1
CASSPSFPPDTQYF	GLNKIVRMY	1
CASSSPGGVTEAFF	GLNKIVRMY	1
CSARDRADRVLIPDTQYF	GLNKIVRMY	1
CSASPVGGAYEQYF	GLNKIVRMY	1
CASELSGNTIYF	KAFSPEVIPMF	1
CATEASGNTIYF	KAFSPEVIPMF	1
CASSHTTGDDYGYTF	KSKRTPMGF	1
CASSLTSTRQPQHF	GPRLGVRAT	1
CASSPPQFTEAFF	GPRLGVRAT	1
CASSSSLVVEQYF	RAQAPPPSW	1
CASSFPGQGNTQYF	RAQAPPPSW	1
CASSVASGQLYGYTF	RLGPVQNEV	1
CASRVGQNYNSPLHF	RLGPVQNEV	1
CASSQDAPGQGSDEQFF	GPRLGVRAT	1
CASSPGTGGPFSEQYF	GPRLGVRAT	1
CASSLVTGNQPQHF	GPRLGVRAT	1
CASSEGDRGLANEKLFF	GPRLGVRAT	1
CASSLGRAGYGETQYF	HYPYRLWHY	1
CASTLTGGNQPQHF	HPVTKYIM	1
CASSPLVSGSGANVLTF	HPVTKYIM	1
CAISESSSGNNEQFF	ATDALMTGF	1
CASSQAPPGQGVDIQYF	GPRLGVRAT	1
CATSGDTQYF	KLVAMGINAV	1
CASSLNWGSGYNEQFF	KLVAMGINAV	1
CASSLEGGDEQFF	KLVAMGINAV	1
CASSVETTGELFF	KLVAMGINAV	1
CASIGWGELFF	KLVAMGINAV	1
CASSTGSAPNEKLFF	IPSINVHHY	1
CASSSGTGPNEKLFF	IPSINVHHY	1
CASSSGTAPNEKLFF	IPSINVHHY	1
CASTSGTGPNEKLFF	IPSINVHHY	1
CASSPGTGPNEKLFF	IPSINVHHY	1
CASTPGTGPNEKLFF	IPSINVHHY	1
CASSPPTAPNEKLFF	IPSINVHHY	1
CASSPGTAPNEKLFF	IPSINVHHY	1
CASSLPSGPNEKLFF	IPSINVHHY	1
CASSLASTPNEKLFF	IPSINVHHY	1
CASSPGTEPNEKLFF	IPSINVHHY	1
CASSPSSGPNEKLFF	IPSINVHHY	1
CASSPTTAPNEKLFF	IPSINVHHY	1
CASSLSTAPNEKLFF	IPSINVHHY	1
CASTPQTAPNEKLFF	IPSINVHHY	1
CASSPSREPNEKLFF	IPSINVHHY	1
CASSAETGPNEKLFF	IPSINVHHY	1
CASSASDSPNEKLFF	IPSINVHHY	1
CASSPPANPNEKLFF	IPSINVHHY	1
CATSTGETPNEKLFF	IPSINVHHY	1
CASSYSTGTPGIYTF	NLVPMVATV	1
CASTPAGGAPGELFF	NLVPMVATV	1
CASSFSGGAPGELFF	NLVPMVATV	1
CASSYQTGTIYGYTF	NLVPMVATV	1
CASSPQTGAIYGYTF	NLVPMVATV	1
CASSALGGGGTGELFF	NLVPMVATV	1
CASSPVQGAFYNSPLHF	NLVPMVATV	1
CSARDFDRTGELFF	NLVPMVATV	1
CSVDETGGGETQYF	NLVPMVATV	1
CASSSLYGDTGELFF	NLVPMVATV	1
CASSLVSGSPTGELFF	NLVPMVATV	1
CASSYATGIGNYGYTF	NLVPMVATV	1
CASNPSGGYTGELFF	NLVPMVATV	1
CASSLTTGTGSYGYTF	NLVPMVATV	1
CASSLLIQGGENTEAFF	NLVPMVATV	1
CASSVQGYTEAFF	NLVPMVATV	1
CASSESMIQHF	NLVPMVATV	1
CASSPRQGGKQPQHF	NLVPMVATV	1
CASHYGGSSYEQYF	NLVPMVATV	1
CAWSVSDIMNTEAFF	NLVPMVATV	1
CSVGGTLDTQYF	NLVPMVATV	1
CASSEVGATNYGYTF	NLVPMVATV	1
CASSSLGGAGTGELFF	NLVPMVATV	1
CASSRPGQGGYEQYF	NLVPMVATV	1
CSARDRSLGNTIYF	GLCTLVAML	1
CASSTSDTQYF	GLCTLVAML	1
CASSHVGGYEQYF	GLCTLVAML	1
CASSLGNTEAFF	GLCTLVAML	1
CSTQEGGYGYTF	GLCTLVAML	1
CASSEGRVLPGELFF	GLCTLVAML	1
CSSQEGGYGYTF	GLCTLVAML	1
CSVPFEGGTLETQYF	GLCTLVAML	1
CASSFGQQETQYF	GLCTLVAML	1
CASSVAGGDEQYF	GLCTLVAML	1
CASSFSRDSDEQFF	GLCTLVAML	1
CASSFEEPQGGLGIYNEQFF	NLVPMVATV	1
CASSIDYYSNQPQHF	NLVPMVATV	1
CASSPRDRANTEAFF	NLVPMVATV	1
CASSYSIRRGVNEQFF	NLVPMVATV	1
CASSLDSTGGDGELFF	NLVPMVATV	1
CANTRGENTEAFF	NLVPMVATV	1
CASSPQAGGGETQYF	NLVPMVATV	1
CASSLRSNTGELFF	NLVPMVATV	1
CSVEGYGQGIGYNEQFF	NLVPMVATV	1
CASSIEGPTGELFF	VAANIVLTV	1
CASGGSSYEQYF	VAANIVLTV	1
CASSSVGVDTQYF	VAANIVLTV	1
CASSIFPNPGNTIYF	VAANIVLTV	1
CASSPFLTGSNTEAFF	VAANIVLTV	1
CASTLTGFAEAFF	VAANIVLTV	1
CASSPSWLSGVTQYF	VAANIVLTV	1
CASSDQETQYF	VAANIVLTV	1
CASSIVSSSYNEQFF	VAANIVLTV	1
CASRAGSFSTDTQYF	VAANIVLTV	1
CASSQEGTAYEQYF	VAANIVLTV	1
CASSPWTGIPYNSPLHF	VAANIVLTV	1
CASSEVGQGFNGYTF	VAANIVLTV	1
CASQSYRVGSEQYF	VAANIVLTV	1
CASSLSAGAPGAEAFF	NLVPMVATV	1
CASSPGSLYYGYTF	NLVPMVATV	1
CASSPITGTGIYGYTF	NLVPMVATV	1
CASSSTNGYTF	NLVPMVATV	1
CASSYATGTAYGYTF	NLVPMVATV	1
CASSLDRVTGELFF	NLVPMVATV	1
CASSLVTGTGWGYTF	NLVPMVATV	1
CASRLQTGTIYGYTF	NLVPMVATV	1
CASSFSTGTAGGYTF	NLVPMVATV	1
CASSFTGIAETQYF	MLNIPSINV	1
CASSLRGPGLYNEQFF	MLNIPSINV	1
CASRSPRAGETQYF	MLNIPSINV	1
CASSFRGDTEAFF	MLNIPSINV	1
CASSLETGSNEQFF	MLNIPSINV	1
CASSWDRRAPSYNEQFF	MLNIPSINV	1
CASSSGGGEQYF	MLNIPSINV	1
CASSLGLNYEQYF	MLNIPSINV	1
CATHSGNTGELFF	MLNIPSINV	1
CASSLSTSGDNEQFF	MLNIPSINV	1
CASSDFRDRGHNEKLFF	MLNIPSINV	1
CATFDGNTGELFF	MLNIPSINV	1
CASRDRGLGQPQHF	MLNIPSINV	1
CASSARTPRPGSSYNEQFF	MLNIPSINV	1
CASSPPGGSGNTIYF	MLNIPSINV	1
CASSFPTGGLWPSDGQYF	MLNIPSINV	1
CAWSVASTGLNYEQYF	MLNIPSINV	1
CASSLGPHDSTNYGYTF	MLNIPSINV	1
CASSFGVNTEAFF	MLNIPSINV	1
CASRPKSPLHF	MLNIPSINV	1
CASSLARRVNPRTDTQYF	MLNIPSINV	1
CASSLQGRGNQPQHF	MLNIPSINV	1
CASSPTGTGEAFF	MLNIPSINV	1
CASSQDRELAFF	MLNIPSINV	1
CASSLAVQSDEQYF	MLNIPSINV	1
CASSPSGYNEQFF	MLNIPSINV	1
CASSPSGGVGTGELFF	MLNIPSINV	1
CAPRVHTGELFF	NLVPMVATV	1
CASSLVGTGGSYEQYF	NLVPMVATV	1
CASSHSRDSYNEQFF	NLVPMVATV	1
CASSPYGQFYEQYF	NLVPMVATV	1
CASSSATYGYTF	NLVPMVATV	1
CASSPGNILYGYTF	NLVPMVATV	1
CASSLTGQETQYF	NLVPMVATV	1
CASSVGGPYTGELFF	NLVPMVATV	1
CASSSASYGYTF	NLVPMVATV	1
CASSQWSNEKLFF	NLVPMVATV	1
CASSLIGGRNGYTF	NLVPMVATV	1
CASSSVNGAFF	NLVPMVATV	1
CASSANLAGDYNEQFF	NLVPMVATV	1
CASSLDVDSYNEQFF	NLVPMVATV	1
CASSSLTGTGYNEQFF	NLVPMVATV	1
CASSSTTGYTF	NLVPMVATV	1
CASSVVGGRYGYTF	NLVPMVATV	1
CASSSVNEAFF	NLVPMVATV	1
CASSSVDEAFF	NLVPMVATV	1
CASSIVNEQFF	NLVPMVATV	1
CASSLSTAEAFF	NLVPMVATV	1
CASSFANYGYTF	NLVPMVATV	1
CASSFTSGTDTQYF	FLGKIWPSHK	1
CASSYVGGDGYTF	FLGKIWPSHK	1
CASSLAAGGDEQYF	FLGKIWPSHK	1
CASSIAIADEKLFF	FLGKIWPSHK	1
CASSLSGGGDTQYF	FLGKIWPSHK	1
CASSEGSQEVFF	FLGKIWPSHK	1
CASSEGLQEVFF	FLGKIWPSHK	1
CASSLERETEAFF	RLRPGGKKR	1
CASSLDWGTFGEQYF	RLRPGGKKR	1
CASSEDESYEQYF	RLRPGGKKR	1
CASSEWNTEAFF	RLRPGGKKR	1
CASSLDRAGDTQYF	RLRPGGKKR	1
CATSDDGASDGNEQFF	RLRPGGKKR	1
CASSQDPAGVGTDTQYF	RLRPGGKKR	1
CASSLGVDSLTDTQYF	RLRPGGKKR	1
CASSAGNGSYEQYF	RLRPGGKKR	1
CASSQDPAGWGTDTQYF	RLRPGGKKR	1
CASSNGVGIAEAFF	RLRPGGKKR	1
CASSVLRAAFF	FLKEKGGL	1
CASRTGGAYNEQFF	FLKEKGGL	1
CASSESPGTSGSPLENQFF	FLKEKGGL	1
CASSPLARVDEQFF	TPGPGVRYPL	1
CSASPRGRYNEQFF	TPGPGVRYPL	1
CASSQVGRRDTQYF	TPGPGVRYPL	1
CATSSPGTSGRHNEQFF	TPGPGVRYPL	1
CASSPRGGYNEQFF	TPGPGVRYPL	1
CSASSRGRVDEQFF	TPGPGVRYPL	1
CASSTGLAGEGRHNEQFF	TPGPGVRYPL	1
CASTGSTSGPSRYNEQFF	TPGPGVRYPL	1
CASSSPLTSGRLNEQFF	TPGPGVRYPL	1
CATSDEVAGGRHHEQFF	TPGPGVRYPL	1
CATRDRQGRYNEQFF	TPGPGVRYPL	1
CASSTPGLAGRHNEQFF	TPGPGVRYPL	1
CASSPRGRDETQYF	FPQGEAREL	1
CASSPRGREETQYF	FPQGEAREL	1
CATSNDRDLDEQFF	RLRPGGKKK	1
CASSPGLDGEQYF	RLRPGGKKK	1
CASSFFLSRERDEQFF	RLRPGGKKK	1
CASSLSGEAGGRYNEQFF	RLRPGGKKK	1
CASSLDRNTGELFF	RLRPGGKKK	1
CASRDSSYEQYF	RLRPGGKKK	1
CASSPGWGLDEQFF	RLRPGGKKK	1
CATSDDGTPNNEQFF	RLRPGGKKK	1
CASSVGWGSETQYF	RLRPGGKKK	1
CASSDTLNTEAFF	RLRPGGKKK	1
CASRDSSYEQYF	RLRPGGRKR	1
CATSDDGTPNNEQFF	RLRPGGRKR	1
CASSDTLNTEAFF	RLRPGGRKR	1
CASSPLGGLGNEQFF	RLRPGGRKR	1
CASSPGWGLDQPQHF	RLRPGGRKR	1
CASSLGWGLDQPQHF	RLRPGGRKR	1
CASSHTTGGRTEAFF	GEIYKRWII	1
CASSTKAGGLADTQYF	GEIYKRWII	1
CASSYSPLNTEAFF	TPRVTGGGAM	1
CASSLHDYTGFGTEAFF	TPRVTGGGAM	1
CASSLGSSPREQFF	TPRVTGGGAM	1
CASSLGTPNEQFF	TPRVTGGGAM	1
CASSLVGVSKDNEQFF	TPRVTGGGAM	1
CASSLHGQGVRSPLHF	TPRVTGGGAM	1
CASSSAEPYNSPLHF	TPRVTGGGAM	1
CASSSHDRAGINSPLHF	TPRVTGGGAM	1
CASSNRTGVPTGELFF	TPRVTGGGAM	1
CASSLHTQGARFF	TPRVTGGGAM	1
CASSQDSLTGQANSPLHF	TPRVTGGGAM	1
CASSSIGQGLGDEQFF	TPRVTGGGAM	1
CASSSHESQGARSPLHF	TPRVTGGGAM	1
CASSLRGESSYNEQFF	TPRVTGGGAM	1
CASSPVGIGEAFF	GILGFVFTL	1
CASSFGMHGYTF	GILGFVFTL	1
CASSMISINEQFF	GILGFVFTL	1
CASSGRSQETQYF	GILGFVFTL	1
CASSIYSGQPQHF	GILGFVFTL	1
CASSLTGTVYEQYF	GILGFVFTL	1
CASSGLSNQPQHF	GILGFVFTL	1
CASSIVSNQPQHF	GILGFVFTL	1
CASSSRSGIEQYF	GILGFVFTL	1
CASSMRSTDTQYF	GILGFVFTL	1
CASGVRSGEVEQFF	GILGFVFTL	1
CASSTRSTSPGHF	GILGFVFTL	1
CASSRYHTDTQYF	GILGFVFTL	1
CASSTRSSETQYF	GILGFVFTL	1
CASSTRSTDTQYF	GILGFVFTL	1
CASSEATGASYEQYF	LLWNGPMAV	1
CASSEGGQAYNEQFF	LLWNGPMAV	1
CASSVATEGYGYTF	LLWNGPMAV	1
CASSLEPGRNEKLFF	IVTDFSVIK	1
CASSSTGGNTIYF	TAFTIPSI	1
CASSLTGNTEAFF	TAFTIPSI	1
CASSPPGGRADTQYF	TAFTIPSI	1
CASAQGRGTEAFF	TAFTIPSI	1
CATSDLQGVRGVNEQFF	TAFTIPSI	1
CASSLTGGGKLFF	TAFTIPSI	1
CASSSGRGGEQYF	TAFTIPSI	1
CASSLTGGNTIYF	TAFTIPSI	1
CASSSNPIVPQETQYF	TAFTIPSI	1
CASSLTGGARARLFF	TAFTIPSI	1
CASRKWNGELFF	TAFTIPSI	1
CASSRRGEGHNEQFF	TAFTIPSI	1
CASSLGEGRVDGYTF	GADGVGKSAL	1
CASSFGQSSTYGYTF	GADGVGKSAL	1
CASSLGRASNQPQHF	GADGVGKSAL	1
CASSLGQTNYGYTF	GADGVGKSAL	1
CASSSQGGYGYTF	KVDPIGHVY	1
CASSFDRGYGYTF	KVDPIGHVY	1
CASSLSGGLLRTGELFF	FVVPYMIYLL	1
CASSGRVTGGFYNEQFF	VQIISCQY	1
CASSFGGAYEQYF	VQIISCQY	1
CASSLVSPSEQFF	YLSNIIPAL	1
CASSLFTGTNEQFF	QLCDVMFYL	1
CASSLDQGAQDNEQFF	YLYDRLLRV	1
CATSFAPGQGEHGYTF	LYPEFIASI	1
CASSTSTGQGWHYGYTF	MLIGIPVYV	1
CASRPSRGTNYGYTF	KLYGLDWAEL	1
CASSERGMVEAFF	KLYGLDWAEL	1
CASSPRNLGPSGSYEQYF	KLYGLDWAEL	1
CASSQNYEQYF	ALDPHSGHFV	1
CASSYSWGAGYEQYF	ALDPHSGHFV	1
CASTPTGAYEQYF	ALDPHSGHFV	1
CSAGTGELFF	ALDPHSGHFV	1
CSARVGDTGELFF	ALSPVIPHI	1
CASSYDSTTGELFF	ALSPVIPHI	1
CASTPGGYEQYF	KLFEFLVYGV	1
CASSQGYEQYF	KLFEFLVYGV	1
CASMGNSAGANVLTF	NLVPMVATV	1
CASRGQGFSYEQYF	NLVPMVATV	1
CASSFLGLNEQFF	NLVPMVATV	1
CASSIGPALNTEAFF	TPRVTGGGAM	1
CASSLGGNLYEQYF	EFFWDANDIY	1
CASSLHDRGSRTEAFF	TPRVTGGGAM	1
CASSPARNTEAFF	RPHERNGFTV	1
CASSPHRNTEAFF	RPHERNGFTV	1
CASSPSRNTEAFF	RPHERNGFTV	1
CASSQAALAGFGYEQYF	RPHERNGFTV	1
CASSSHDRQGASSPLHF	TPRVTGGGAM	1
CASSSHDTGGYNSPLHF	TPRVTGGGAM	1
CASSSVSEAFF	NLVPMVATV	1
CASSYQTGTGNYGYTF	NLVPMVATV	1
CASSYSGHVYEQYF	NLVPMVATV	1
CASSAPTGELFF	HPVGEADYFEY	1
CASSARTGELFF	HPVGEADYFEY	1
CASSPRRYNEQFF	HPVGEADYFEY	1
CASSGITSGEYTIYF	HPVGEADYFEY	1
CASRQDRDYQETQYF	HPVGEADYFEY	1
CASSVRTGELFF	HPVGEADYFEY	1
CASSVRSGELFF	HPVGEADYFEY	1
CASSSRSGELFF	HPVGEADYFEY	1
CASSAREGKLFF	HPVGEADYFEY	1
CASSLKSGELFF	HPVGEADYFEY	1
CASSAPAGELFF	HPVGEADYFEY	1
CASSVRPGLAGGGTGELFF	HPVGEADYFEY	1
CASSGREHEQYF	HPVGEADYFEY	1
CASSAPSGEQFF	HPVGEADYFEY	1
CASSPRRYNLQFF	HPVGEADYFEY	1
CAISDPGTLPNYGYTF	HPVGEADYFEY	1
CAISESDPLRGTEAFF	HPVGEADYFEY	1
CASSFSGNTGELFF	RAKFKQLL	1
CASSWGGGSHYGYTF	IVTDFSVIK	1
CASSLRDGSEAFF	RAKFKQLL	1
CSVDLEANYGYTF	KLGGALQAK	1
CASRTGLASTDTQYF	IVTDFSVIK	1
CASSARSTGELFF	GILGFVFTL	1
CASSSRSSGEQYF	GILGFVFTL	1
CASSFRSTDTQYF	GILGFVFTL	1
CASSAQANQPQHF	GILGFVFTL	1
CAVLVDPYNEQFF	GILGFVFTL	1
CASSVDPAGGSSYEQYF	GILGFVFTL	1
CASSYLAGEITDTQYF	GILGFVFTL	1
CASSSPKGAKYEQYF	GILGFVFTL	1
CASSIYSNQPQHF	GILGFVFTL	1
CASSMVGGSYNEQFF	GILGFVFTL	1
CASSIRSGYEQYF	GILGFVFTL	1
CASSIRASGVEQFF	GILGFVFTL	1
CASSGRSSQPQHF	GILGFVFTL	1
CASSSRSHQPQHF	GILGFVFTL	1
CASSIRSGYEQFF	GILGFVFTL	1
CASSPTLQGPLGETQYF	GILGFVFTL	1
CASSPSLAGYGNEQFF	GILGFVFTL	1
CASSLFGSPLHF	GILGFVFTL	1
CASSTGLYGYTF	GILGFVFTL	1
CASSIRAGETQYF	GILGFVFTL	1
CASYTSDYGYTF	GILGFVFTL	1
CASSAGRVSPGELFF	GLCTLVAML	1
CASSPGTLSAGELFF	GLCTLVAML	1
CASTAGQTTNFNEQFF	GLCTLVAML	1
CASSELGRFIIQPQHF	GLCTLVAML	1
CASSKWTGGNQWFF	GLCTLVAML	1
CASSEGRVLSGELFF	GLCTLVAML	1
CSGGTDGTNEKLFF	GLCTLVAML	1
CASSTGRVAPGELFF	GLCTLVAML	1
CASSYMGVEQFF	YVLDHLIVV	1
CASRTTSGGASEQFF	YVLDHLIVV	1
CASSDLANEQFF	YVLDHLIVV	1
CATSDWAGEMETQYF	YVLDHLIVV	1
CASTTEGGLIHEKLFF	YVLDHLIVV	1
CASRATMGGGTEAFF	YVLDHLIVV	1
CASSRGQGSADTQYF	YVLDHLIVV	1
CASSPGAGLYNEQFF	YVLDHLIVV	1
CASSLHFEVEKLFF	YVLDHLIVV	1
CSANDRSYNEQFF	YVLDHLIVV	1
CSAIPSYLSIGEQFF	YVLDHLIVV	1
CASSLAVEGVSRMNTEAFF	YVLDHLIVV	1
CASSLTTGIQYF	YVLDHLIVV	1
CASSFRLGQGHYGYTF	YVLDHLIVV	1
CASSSLQGNGQPQHF	YVLDHLIVV	1
CASSLDLSSGANVLTF	YVLDHLIVV	1
CASSPPLGLHTGELFF	YVLDHLIVV	1
CASSFSLGAAGELFF	YVLDHLIVV	1
CASSLSVSTSLDTQYF	YVLDHLIVV	1
CASSSPGGRGNTEAFF	YVLDHLIVV	1
CAWSGLSGSYNEQFF	YVLDHLIVV	1
CASSYPFGGAWDEQFF	IPSINVHHY	1
CASSLFTDNRDGYTF	IPSINVHHY	1
CASSYATAYEQYF	IPSINVHHY	1
CSAQPGQENIQYF	IPSINVHHY	1
CASSLFTDRRDGYTF	IPSINVHHY	1
CASNGQGARDGYTF	IPSINVHHY	1
CASGRTGSEAFF	IPSINVHHY	1
CASSQGLAEWDEQFF	IPSINVHHY	1
CASSLALDEAFF	IPSINVHHY	1
CASSLARGFSDHTQYF	TPRVTGGGAM	1
CASSLIGVGLTDTQYF	TPRVTGGGAM	1
CASSSSWGYGYTF	TPRVTGGGAM	1
CASRPNLGGTTEAFF	TPRVTGGGAM	1
CASSIHSETGVGSPLHF	TPRVTGGGAM	1
CASSLSASTARYGYTF	TPRVTGGGAM	1
CASKQEWGNTEAFF	TPRVTGGGAM	1
CASSLIGAGGPDEQFF	TPRVTGGGAM	1
CASSSLPGGTEAFF	NLVPMVATV	1
CASSPTTGTGHYGYTF	NLVPMVATV	1
CASNPMGQGILFF	NLVPMVATV	1
CASSLDSIASGNTIYF	VLEETSVML	1
CASSLVSGGWTEAFF	VLEETSVML	1
CASSQETDLRSQPQHF	VLEETSVML	1
CASKWGRDLWQPQHF	VLEETSVML	1
CASSEASGGFYNEQFF	IVTDFSVIK	1
CASSLAGGSYNSPLHF	IVTDFSVIK	1
CASSAWDINTGELFF	IVTDFSVIK	1
CASSRTSGGFYNEQFF	IVTDFSVIK	1
CASSGSSGGYYNEQFF	IVTDFSVIK	1
CASSLGSGNYGYTF	IVTDFSVIK	1
CASSVGDWAQGNTIYF	IVTDFSVIK	1
CASSQETGSASQHF	RPPIFIRRL	1
CASSQDRYTGGYTF	RPPIFIRRL	1
CAGSQDRLTGGYTF	RPPIFIRRL	1
CASSLVLSSPTYEQYF	RAKFKQLL	1
CASSSHVINQFF	RAKFKQLL	1
CASSLWIQETQYF	RAKFKQLL	1
CASSPTGAGNQPQHF	RAKFKQLL	1
CASSGSAGGVWDNEQFF	RAKFKQLL	1
CASTSAGTPDNEQFF	RAKFKQLL	1
CASSLTVAGDTEAFF	RAKFKQLL	1
CASSQGPNLQETQYF	RAKFKQLL	1
CASSTTRAGDQPQHF	RAKFKQLL	1
CASSQSIGGELFF	RAKFKQLL	1
CASSLVTGEGLGEQFF	RAKFKQLL	1
CASSFMQGDSPLHF	RAKFKQLL	1
CASSQGTGGGYGYTF	RAKFKQLL	1
CASSLMGNSPLHF	RAKFKQLL	1
CASSLMASGGYNEQFF	RAKFKQLL	1
CASSLWAGGLYEQFF	RAKFKQLL	1
CASSFVGEGYEQYF	RAKFKQLL	1
CATSSFPRLEWDEQFF	RAKFKQLL	1
CASSPGTGSYEQYF	RAKFKQLL	1
CASRYTGQETYEQYF	RAKFKQLL	1
CASSFSGQGAATNEKLFF	RAKFKQLL	1
CASSLLGTENTEAFF	RAKFKQLL	1
CASGTGESGYTF	RAKFKQLL	1
CASSTPTSGVNTGELFF	RAKFKQLL	1
CASSLLGQYNSPLHF	RAKFKQLL	1
CASSLMGVRDTEAFF	RAKFKQLL	1
CASSQETGSYEQFF	RAKFKQLL	1
CASSPWASGTQETQYF	RAKFKQLL	1
CASSRLDRDSYEQYF	RAKFKQLL	1
CATKRTGTDTQYF	RAKFKQLL	1
CASSSTGRDTDTQYF	RAKFKQLL	1
CASNILGQAIDTQYF	RAKFKQLL	1
CASSFRGEGSYEQYF	RAKFKQLL	1
CASSLGRDGVYF	RAKFKQLL	1
CASSQLGQSETQYF	RAKFKQLL	1
CASSATGLSVTDTQYF	RAKFKQLL	1
CASSLLGQDNSPLHF	RAKFKQLL	1
CASSPGQGVTPLHF	RAKFKQLL	1
CASSSDPSGSIAYEQYF	RAKFKQLL	1
CASSPTSGEYNEQFF	RAKFKQLL	1
CASSLDSQSSGNTIYF	RAKFKQLL	1
CASSPYGIDEQYF	RAKFKQLL	1
CASSGLNSPLHF	RAKFKQLL	1
CASRDPGLAGEGHGELFF	RAKFKQLL	1
CASSLILDSPLHF	MTLHGFMMY	1
CASSVTFRTGPMYGYTF	MTLHGFMMY	1
CASSLDLDSDGYTF	MTLHGFMMY	1
CASSESENSYGYTF	MTLHGFMMY	1
CASSPTLYNEQFF	VYALIAGATL	1
CASSLSYLNEQFF	VYALIAGATL	1
CASHPVGSLTDTQYF	VYALIAGATL	1
CASSEWVFWSSYNSPLHF	VYALIAGATL	1
CASSLGPVYEQYF	TLWCSPIKV	1
CASSEGHFSGNTIYF	TLWCSPIKV	1
CASGGAIDTDTQYF	TLWCSPIKV	1
CASSSGLAGEQFF	TLWCSPIKV	1
CASSFFGSNQPQHF	TLWCSPIKV	1
CASSFSNDYEQYF	TLWCSPIKV	1
CASGSSGQGEYGELFF	TLWCSPIKV	1
CASSEDLLRDTHQPQHF	TLWCSPIKV	1
CASSLIQVGYEQYF	TLWCSPIKV	1
CASSESRSGNQPQHF	FMPDFDLHL	1
CASSLYRGTGELFF	FMPDFDLHL	1
CASSHQAGALYNEQFF	EVLPFFLFF	1
CASSLNSGHTQYF	QTNPVTLQY	1
CATGTGGNDYEQYF	TLYSLTLLY	1
CASSNRGYDEQYF	TEDEHFEFY	1
CSVEDRRGPFYGYTF	TEDEHFEFY	1
CASSQYAVRVGDTEAFF	FLIYLDVSV	1
CASSPPGRYYEQYF	FLIYLDVSV	1
CATSEGPGQGISGANVLTF	FLIYLDVSV	1
CASSFGGGLQETQYF	CISSCNPNL	1
CASSSTRGWADTQYF	KLTESLHKV	1
CASGTGDSNQPQHF	EPLPQGQLTAY	1
CASSTGDSNQPQHF	EPLPQGQLTAY	1
CASSLIGRDEQFF	EPLPQGQLTAY	1
CASAQIGPYEQYF	EPLPQGQLTAY	1
CANSQPGGIEQFF	EPLPQGQLTAY	1
CASSLVVAGGPMSEQFF	EPLPQGQLTAY	1
CASSFYDWNTEAFF	EPLPQGQLTAY	1
CAISTGDYEQYF	EPLPQGQLTAY	1
CAISTGPDSYEQYF	EPLPQGQLTAY	1
CAIGTGDSNQPQHF	EPLPQGQLTAY	1
CATSTGDSNQPQHF	EPLPQGQLTAY	1
CASSLISGEGQPQHF	EPLPQGQLTAY	1
CASSLPGAGGDQPQHF	EPLPQGQLTAY	1
CASRPPGGVNEQFF	EPLPQGQLTAY	1
CASRPPGGNEQFF	EPLPQGQLTAY	1
CASRLPGGYNEQFF	EPLPQGQLTAY	1
CASRQPGGVNEQFF	EPLPQGQLTAY	1
CASRPPGANVLTF	EPLPQGQLTAY	1
CASRTPGVSTEAFF	EPLPQGQLTAY	1
CASSLPGGAQGYTF	EPLPQGQLTAY	1
CASSLPGRDEQYF	EPLPQGQLTAY	1
CASTLWSATNEKLFF	NLVPMVATV	1
CSVGAIMDEQFF	GLCTLVAML	1
CASSQAGLAAYNEQFF	GLCTLVAML	1
CSVTGDRRSNQPQHF	GLCTLVAML	1
CSARDRVGNGHTF	GLCTLVAML	1
CSARDTVGNGYTF	GLCTLVAML	1
CSARLRELSGNTIYF	GLCTLVAML	1
CSARLRKLSGNTIYF	GLCTLVAML	1
CSGREDSTNEKLFF	GLCTLVAML	1
CASSFIGGVDGYTF	NLVPMVATV	1
CATGRGGKIGEQYF	NLVPMVATV	1
CATGRGGMIGEQYF	NLVPMVATV	1
CSATDVTKGQLISGYTF	NLVPMVATV	1
CSARGQGDEQYF	GLCTLVAML	1
CASSVRAGETQYF	GILGFVFTL	1
CSVGAGGTNEKLFF	GLCTLVAML	1
CSVGTQGTNEKLFF	GLCTLVAML	1
CASSQSPGGQQFF	GLCTLVAML	1
CASSQEEGPGNQPQHF	NLVPMVATV	1
CASSDAGGGMAEAFF	GILGFVFTL	1
CASSSRSAGELFF	GILGFVFTL	1
CASSSRSANEQFF	GILGFVFTL	1
CASSKRSTDTQYF	GILGFVFTL	1
CASSILTGPRTEAFF	GILGFVFTL	1
CSARVRGDVYGYTF	GILGFVFTL	1
CASSTRSGYEQYF	GILGFVFTL	1
CAPLKGSSYEQYF	GILGFVFTL	1
CASSGGRNQPQHF	GILGFVFTL	1
CATEQGMHEQYF	NLVPMVATV	1
CASSQDWGAGTQYF	GILGFVFTL	1
CASSLIFPSGEQYF	GILGFVFTL	1
CASSLFPGFGEQYF	GILGFVFTL	1
CASASANYGYTF	NLVPMVATV	1
CASSIQALLTF	NLVPMVATV	1
CASSSRSRQYRGSSYEQYF	GILGFVFTL	1
CAVNGGSNYGYTF	NLVPMVATV	1
CASSPLIGEQYF	GILGFVFTL	1
CASSEAISGAWDEQFF	GILGFVFTL	1
CSVPITVQETQYF	GLCTLVAML	1
CASSTKVGGTGELFF	GILGFVFTL	1
CASSIFSGGQNIQYF	GILGFVFTL	1
CASSQVEAFYEQYF	GILGFVFTL	1
CASSIFGGAEAFF	GILGFVFTL	1
CASSLSRRGPNYGYTF	GILGFVFTL	1
CASSSPTSGDYEQYF	GILGFVFTL	1
CASGLVPGGLVYEQYF	GILGFVFTL	1
CASSVVASSYNEQFF	GILGFVFTL	1
CASSYGLEQFF	GILGFVFTL	1
CASSILSNTEAFF	GILGFVFTL	1
CASGAGGPLNEQFF	GILGFVFTL	1
CASSAQTGASYGYTF	NLVPMVATV	1
CASSKQTGTGNYGYTF	GILGFVFTL	1
CASSWKTGTGGTGYTF	NLVPMVATV	1
CASSYQTGTGVYGYTF	NLVPMVATV	1
CASSSRSAYEQYF	GILGFVFTL	1
CASSFGTFETQYF	GLCTLVAML	1
CASSPITGTGAYGYTF	NLVPMVATV	1
CATQGDNTYEQYF	GILGFVFTL	1
CATAITSTQYF	NLVPMVATV	1
CASSMTSGALYNEQFF	NLVPMVATV	1
CASSLSGGINEQFF	GLCTLVAML	1
CASSPRGGMTQHF	GILGFVFTL	1
CSAEPGTSGGLQYF	GLCTLVAML	1
CASSLERNTYEQYF	GILGFVFTL	1
CASSVGGEAYEQYF	GLCTLVAML	1
CSARDGTRAHYEQFF	GILGFVFTL	1
CASSVEDYGSVSYGYTF	GILGFVFTL	1
CASSRVGTTYEQYF	GILGFVFTL	1
CASSQDLAGEGTDTQYF	GILGFVFTL	1
CATSDFPPGVRGAPQETQYF	GILGFVFTL	1
CASSYFDEKLFF	NLVPMVATV	1
CASSIGYYGYTF	GILGFVFTL	1
CASSIVNEAFF	NLVPMVATV	1
CASSETSGRSPYEQYF	NLVPMVATV	1
CASGPGTSATDTQYF	NLVPMVATV	1
CASSQMTGLNTEAFF	GILGFVFTL	1
CASSMRSSYEQYF	GILGFVFTL	1
CSARDGLAGHYEQYF	NLVPMVATV	1
CASSPLSLGSPYNEQFF	GILGFVFTL	1
CASSQDPGYEQYF	GILGFVFTL	1
CASSSVSGYTF	NLVPMVATV	1
CASSYSGHVNTEAFF	GILGFVFTL	1
CASSLGIYGYTF	GILGFVFTL	1
CATSDGLAGGWANVLTF	GILGFVFTL	1
CASSPSTGVTFYGYTF	NLVPMVATV	1
CAWSISDLAKNIQYF	NLVPMVATV	1
CAWSVSDVANTEAFF	NLVPMVATV	1
CASSSQSNQPQHF	GILGFVFTL	1
CASTPQGAYEQYF	GILGFVFTL	1
CATSDFEVAGSSYNEQFF	GILGFVFTL	1
CASSSGQLTNTEAFF	GLCTLVAML	1
CSARGDGQGDLLQETQYF	GLCTLVAML	1
CSARDRGLGNTIYF	GLCTLVAML	1
CASSQSPGGIAFF	GLCTLVAML	1
CSVGAAGTNEKLFF	GLCTLVAML	1
CASGGGGFQETQYF	GLCTLVAML	1
CSARDRAYGNTIYF	GLCTLVAML	1
CASSLAAGLNLKNIQYF	GLCTLVAML	1
CAISGEFGSGANVLTF	GLCTLVAML	1
CASSYSSGKTDTQYF	GLCTLVAML	1
CASSPGLTYPGELFF	GLCTLVAML	1
CASSEGQVSPGELFF	GLCTLVAML	1
CASSKGSVAPGELFF	GLCTLVAML	1
CSAMAGGLRIYNEQFF	GLCTLVAML	1
CASSFSSGTTDTQYF	GLCTLVAML	1
CASSVGELAGGIDTQYF	GLCTLVAML	1
CASSVAELAGGTDTQYF	GLCTLVAML	1
CASSLRNSYEQFF	GLCTLVAML	1
CSVGSEGTNEKLFF	GLCTLVAML	1
CSVEGATSEQFF	GLCTLVAML	1
CSVRGEGDTQYF	GLCTLVAML	1
CASSPEQGYQETQYF	GLCTLVAML	1
CASNPGTSNEQFF	GLCTLVAML	1
CASSQGSELMTGNTIYF	GLCTLVAML	1
CASSQSPGGYQFF	GLCTLVAML	1
CASSPPSGSGFNEQFF	GLCTLVAML	1
CASRPGTASYEQYF	CPSQEPMSIYVY	1
CASRPGTSSYEQYF	CPSQEPMSIYVY	1
CAWSEPQNLPSLYGYTF	FPTKDVAL	1
CAWSVASGANNEQFF	FPTKDVAL	1
CAWSVAAGILEQFF	FPTKDVAL	1
CASSLVAGYGSYNEQFF	FPTKDVAL	1
CASSQDRASPLHEQFF	FPTKDVAL	1
CASSQDWGDGYTF	FPTKDVAL	1
CASSQVGHEQFF	FPTKDVAL	1
CAWSPTGDQPQHF	FPTKDVAL	1
CAWSEPGLDQPQHF	FPTKDVAL	1
CAWSLASGGTDNEQFF	FPTKDVAL	1
CASSSRDRGPHGQYF	TPRVTGGGAM	1
CASSSRDLGEYEQYF	TPRVTGGGAM	1
CASSHDYRGRRSPLHF	TPRVTGGGAM	1
CASSLIGEGTGWHQYF	TPRVTGGGAM	1
CASSLVGVGLLLNEQYF	TPRVTGGGAM	1
CASSPVTGTGHYGYTF	NLVPMVATV	1
CAWVPTGTGGTEAFF	NLVPMVATV	1
CASSSHDYRGRRSPLHF	TPRVTGGGAM	1
CASSNRDRGDYEQYF	TPRVTGGGAM	1
CASSEVGVFEAFF	DATYQRTRALVR	1
CASSLGVNTEAFF	DATYQRTRALVR	1
CSFRDLSSYNEQFF	DATYQRTRALVR	1
CASSPALGDQETQYF	DATYQRTRALVR	1
CASRPGQHTGELFF	DATYQRTRALVR	1
CSVEEGLQTGELFF	DATYQRTRALVR	1
CSAETGNTEAFF	DATYQRTRALVR	1
CASSEVADYNEQFF	DATYQRTRALVR	1
CASSLEGDTEAFF	DATYQRTRALVR	1
CASSEFQGDNEQFF	DATYQRTRALVR	1
CASSDGSFNEQFF	DATYQRTRALVR	1
CASSVGDLLTGELFF	DATYQRTRALVR	1
CATSDLEGWTQYF	DATYQRTRALVR	1
CANPPGSSYNEQFF	DATYQRTRALVR	1
CSATRLAGGPTDTQYF	DATYQRTRALVR	1
CASSVALGNQETQYF	DATYQRTRALVR	1
CASSQAGSSYEQYF	DATYQRTRALVR	1
CSAEQGNTEAFF	DATYQRTRALVR	1
CASSPGTGGNEQYF	DATYQRTRALVR	1
CASSLDLPGPEGETQYF	DATYQRTRALVR	1
CSAEDGNSPLHF	DATYQRTRALVR	1
CAWSPAGLAMYEQYF	DATYQRTRALVR	1
CASSEAGGPGYEQYF	DATYQRTRALVR	1
CSVRDISTNEKLFF	DATYQRTRALVR	1
CSAESGNTEAFF	DATYQRTRALVR	1
CASSSPSGVYNEQFF	DATYQRTRALVR	1
CASSVDLKAGEEGEQFF	DATYQRTRALVR	1
CASSGQGGYTF	KAFSPEVIPMF	1
CATTDTYGYTF	KAFSPEVIPMF	1
CASSSRQNYGYTF	KAFSPEVIPMF	1
CASSGQLYGYTF	KAFSPEVIPMF	1
CASSATYGYTF	KAFSPEVIPMF	1
CASTGTAYGYTF	KAFSPEVIPMF	1
CASTGTDYGYTF	KAFSPEVIPMF	1
CASSGQNYGYTF	KAFSPEVIPMF	1
CASSGRNYGYTF	KAFSPEVIPMF	1
CAWTGTNYGYTF	KAFSPEVIPMF	1
CASSREVYGYTF	KAFSPEVIPMF	1
CASSTSYGYTF	KAFSPEVIPMF	1
CAAGGQFYGYTF	KAFSPEVIPMF	1
CASSLTAPDTDAFF	KAFSPEVIPMF	1
CATTGSYGYTF	KAFSPEVIPMF	1
CASTGGSYGYTF	KAFSPEVIPMF	1
CASSGTSYGYTF	KAFSPEVIPMF	1
CSARLRDRGYEQYF	KAFSPEVIPMF	1
CSARPQGQTVALHF	KAFSPEVIPMF	1
CSARPGQGTVALHF	KAFSPEVIPMF	1
CASSPDRARDGYTF	KAFSPEVIPMF	1
CASSFLLDGYTF	KAFSPEVIPMF	1
CASSSWEGLDTQYF	KAFSPEVIPMF	1
CSVEDPDRPSYGYTF	KAFSPEVIPMF	1
CASEDSSDGANYGYTF	KAFSPEVIPMF	1
CASEAGNTIYF	KAFSPEVIPMF	1
CASSWSGGQRGYTF	KAFSPEVIPMF	1
CASSPRDSKETQYF	KAFSPEVIPMF	1
CASSLAGGQETQYF	KAFSPEVIPMF	1
CASSYSDGNEAFF	KAFSPEVIPMF	1
CASSLAGTQETQYF	KAFSPEVIPMF	1
CASSQRQDSSYNEQFF	KAFSPEVIPMF	1
CASTASYGYTF	KAFSPEVIPMF	1
CASSPYAGSEQFF	KAFSPEVIPMF	1
CATSGEGQGGPYGYTF	KAFSPEVIPMF	1
CAGSLSNGYTF	KAFSPEVIPMF	1
CASSGTASFDEQFF	KAFSPEVIPMF	1
CASSGTTSFDEQFF	KAFSPEVIPMF	1
CASSVGEGFDIQYF	KAFSPEVIPMF	1
CASSSLIRGLGNQPQHF	KAFSPEVIPMF	1
CASSESRMGSQANYGYTF	KAFSPEVIPMF	1
CASSLAETSADGYTF	KAFSPEVIPMF	1
CASSSFLSSGETQYF	KAFSPEVIPMF	1
CASSTGLAGGKEQYF	KRWIILGLNK	1
CASSQGTSDYEQYF	KRWIILGLNK	1
CASGFGGTEAFF	KRWIILGLNK	1
CSAREGQGSIEQYF	KRWIILGLNK	1
CASSSRTGELFF	KRWIILGLNK	1
CASSVVSDNEQFF	KRWIILGLNK	1
CASATGIFNNEQFF	KRWIILGLNK	1
CASSAQTGFLFF	KRWIILGLNK	1
CASSPGRLSHEQFF	KRWIILGLNK	1
CASSAGISAYEQYF	KRWIILGLNK	1
CASSPGQVAYEQYF	KRWIILGLNK	1
CSAREGVAGALYEQYF	KRWIILGLNK	1
CASSQGVLAYEQYF	KRWIILGLNK	1
CASSLDRGEQFF	KRWIILGLNK	1
CSPGTDLYEQYF	GLCTLVAML	1
CASSYWVGRRDTQYF	GLCTLVAML	1
CSGTGGTNEKLFF	GLCTLVAML	1
CASSQEGGGQGQPQHF	TPQDLNTML	1
CASSLATDGYTF	TPQDLNTML	1
CASSQEGGGDGQPQHF	TPQDLNTML	1
CASSFGLDEAFF	TPQDLNTML	1
CASSLGPTEAFF	TPQDLNTML	1
CASSLDPEKGAFF	TPQDLNTML	1
CASSLGVNTIYF	TPQDLNTML	1
CASSQGPTEAFF	TPQDLNTML	1
CASSLNGADGYTF	TPQDLNTML	1
CASSSQTSGLFANTGELFF	TPQDLNTML	1
CASSLVFGTAGGQQFF	TPQDLNTML	1
CASSLGANTIYF	TPQDLNTML	1
CASSLAFGTSGGEQYF	TPQDLNTML	1
CASSLSDVSWNTEAFF	TPQDLNTML	1
CASSSTITGMGDSGNTIYF	TPQDLNTML	1
CASRASTGSGNTIYF	TPQDLNTML	1
CASSDNPLVGGFTDTQYF	IIKDYGKQM	1
CSDDGGQEGYGYTF	IIKDYGKQM	1
CASSLALRGGDQETQYF	IIKDYGKQM	1
CASSSLRGTAADTQYF	IIKDYGKQM	1
CSVEGMRDYGYTF	IIKDYGKQM	1
CASRGSGVYEQYF	IIKDYGKQM	1
CASSLVDPTGFGLETQYF	IIKDYGKQM	1
CASSVDKGGADEQFF	IIKDYGKQM	1
CASSVDKGGTDTQYF	IIKDYGKQM	1
CASRGTGVHEQYF	IIKDYGKQM	1
CASSVDKGGADTQYF	IIKDYGKQM	1
CASRTSGGHEQFF	IIKDYGKQM	1
CASRTSGEETQYF	IIKDYGKQM	1
CASSEDKGGGDTQYF	IIKDYGKQM	1
CASSVDKGGVDEQFF	IIKDYGKQM	1
CASGDSGDEQFF	IIKDYGKQM	1
CASALEQGGYNEQFF	IIKDYGKQM	1
CASSVDKGGTDEQFF	IIKDYGKQM	1
CASSHLDSGLAVDTEAFF	FPRPWLHGL	1
CASSFRQGLGHTGELFF	FPRPWLHGL	1
CASSLWSGASNEQFF	FPRPWLHGL	1
CASSLYSGADQPQHF	FPRPWLHGL	1
CASSLWGGDFSQEQFF	FPRPWLHGL	1
CASSLWSGVGDGYTF	FPRPWLHGL	1
CASSLYGGPEQPQHF	FPRPWLHGL	1
CASSPISDRSGNTIYF	FPRPWLHGL	1
CASSLFSGPSQTQYF	FPRPWLHGL	1
CASSLYSGGGQPQHF	FPRPWLHGL	1
CASSLYSGGDKEQYF	FPRPWLHGL	1
CASSLYGSPDQPQHF	FPRPWLHGL	1
CASSLYGGGDQPQHF	FPRPWLHGL	1
CSGGGYGSGTYEQYF	FPRPWLHGL	1
CASSLWAGETEAFF	FPRPWLHGL	1
CASSIKGYNEQFF	FPRPWLHGL	1
CASSIQTGNSPLHF	FPRPWLHGL	1
CASSLWSGIADTQYF	FPRPWLHGL	1
CASSLWAGGSNEQFF	FPRPWLHGL	1
CASSLFGSPEQPQHF	FPRPWLHGL	1
CASSLYTGSDQPQHF	FPRPWLHGL	1
CASQLYSGGDQPQHF	FPRPWLHGL	1
CASSLYSGPDQPQHF	FPRPWLHGL	1
CASSLWGGPTNEQYF	FPRPWLHGL	1
CASSSVDRSSYEQYF	FPRPWLHGL	1
CASSLWGGSSNEQFF	FPRPWLHGL	1
CASSLFSGGDQPQHF	FPRPWLHGL	1
CASSLERSSEQYF	FPRPWLHGL	1
CASSQDRGPDTQYF	FPRPWLHGL	1
CASSEGRDQETQYF	FPRPWLHGL	1
CASSLVGPPGELFF	LPPIVAKEI	1
CASSRSGLYEQYF	LPPIVAKEI	1
CASSSRDGQEQYF	LPPIVAKEI	1
CASSHGMGASTSGYTF	LPPIVAKEI	1
CASSFPQNTEAFF	LPPIVAKEI	1
CASSDRQSLVQFF	LPPIVAKEI	1
CASSKPLYEQYF	LPPIVAKEI	1
CASSPIQGSEQYF	LPPIVAKEI	1
CASSSKDGQSQYF	LPPIVAKEI	1
CASSWTGPPGEQFF	LPPIVAKEI	1
CASSPRQGKEQFF	LPPIVAKEI	1
CASSLAQSREQYF	LPPIVAKEI	1
CASSSRQGKEAFF	LPPIVAKEI	1
CASSPRQGHEQYF	LPPIVAKEI	1
CASSPRTGGTEAFF	LPPIVAKEI	1
CASSLVGPPGEAFF	LPPIVAKEI	1
CASRDRQSHEQYF	LPPIVAKEI	1
CSARGLGVNTEAFF	LPPIVAKEI	1
CASIPNLGNEQFF	LPPIVAKEI	1
CASSLWGAKMNTEAFF	LPPIVAKEI	1
CSATDRASGIEQYF	HPKVSSEVHI	1
CSATSRDSALEQYF	HPKVSSEVHI	1
CASSQEGWDGRYEQYF	HPKVSSEVHI	1
CSATDRDGGLEQYF	HPKVSSEVHI	1
CASSLGPVEAFF	HPKVSSEVHI	1
CSATSRDRGLEQYF	HPKVSSEVHI	1
CASSLSRTGFYEQYF	HPKVSSEVHI	1
CASSLGADQPQHF	HPKVSSEVHI	1
CASGAAMNTEAFF	HPKVSSEVHI	1
CASSLGPAAGYTF	HPKVSSEVHI	1
CASRRGSTYNEQFF	HPKVSSEVHI	1
CASRPPDTGELFF	HPKVSSEVHI	1
CSATSRDGDNEQFF	HPKVSSEVHI	1
CASSLGPLTGLGPEAFF	HPKVSSEVHI	1
CASSLGPRYEQYF	HPKVSSEVHI	1
CASSFTRQSPYNEQFF	HPKVSSEVHI	1
CASSLGPTVPGNTIYF	HPKVSSEVHI	1
CSATSRQGGREQYF	HPKVSSEVHI	1
CASSSFRDGGTDTQYF	HPKVSSEVHI	1
CASRGGPLTEAFF	HPKVSSEVHI	1
CSATNRDRGLEQYF	HPKVSSEVHI	1
CASSFDKGYEQYF	HPKVSSEVHI	1
CATRGRGSEETQYF	HPKVSSEVHI	1
CASSLGPAIPGNTIYF	HPKVSSEVHI	1
CASRGADTGELFF	HPKVSSEVHI	1
CASSPRGGGETQYF	TPGPGVRYPL	1
CASSVSGGQVTDTQYF	TPGPGVRYPL	1
CASSQDRATQETQYF	TPGPGVRYPL	1
CASSQYRATQETQYF	TPGPGVRYPL	1
CASYRSDRPTEAFF	TPGPGVRYPL	1
CASRKGIQETQYF	TPGPGVRYPL	1
CASSTFGATQETQYF	TPGPGVRYPL	1
CASSLSRQGTGELFF	TPGPGVRYPL	1
CASSYYSGGSSYNEQFF	TPGPGVRYPL	1
CASSYSRTDLKNIQYF	TPGPGVRYPL	1
CSVKLTEFGYTF	TPGPGVRYPL	1
CASSPRGTRTDTQYF	TPGPGVRYPL	1
CASRRGFHQPQHF	TPGPGVRYPL	1
CSAPEPTSGRWSGELFF	TPGPGVRYPL	1
CASSRQGGQTTDTQYF	TPGPGVRYPL	1
CASSLPPGGGVYGYTF	TPGPGVRYPL	1
CASSVGPGQEIHTDTQYF	TPGPGVRYPL	1
CASSVWGDPSYEQYF	TPGPGVRYPL	1
CASRPIGGAQETQYF	TPGPGVRYPL	1
CASNPGTGTDTQYF	IPSINVHHY	1
CASNPGTGADEQYF	IPSINVHHY	1
CASNAGTGNEQYF	IPSINVHHY	1
CASNAGTGTDTQYF	IPSINVHHY	1
CAISVAARGEQFF	IPSINVHHY	1
CAISETTRGDSPLHF	IPSINVHHY	1
CAISGRGDTEAFF	IPSINVHHY	1
CASSLGAGTFKTNEKLFF	IPSINVHHY	1
CASSLTDGDQPQHF	IPSINVHHY	1
CASSLVASQETQYF	IPSINVHHY	1
CASSTPGEGGEQFF	SLYNTVATL	1
CASSDRTGGGETQYF	SLYNTVATL	1
CASSYGMGVGDRDTQYF	SLYNTVATL	1
CASSRTAGTYYNEQFF	SLYNTVATL	1
CASSLPTENTDTQYF	SLYNTVATL	1
CASSASTGGGYTF	SLYNTVATL	1
CASSFLAGGITDTQYF	SLYNTVATL	1
CATSDPIRASSHEQFF	SLYNTVATL	1
CASSPNGDRVFDQPQHF	EIYKRWII	1
CASSENSLGRGLVKTQYF	EIYKRWII	1
CASSPPMGRAEGYTF	EIYKRWII	1
CASSPLAVGKETQYF	EIYKRWII	1
CASSLSGRGATEAFF	EIYKRWII	1
CASSLMDRTEAFF	EIYKRWII	1
CAITDGNGPRIGYTF	EIYKRWII	1
CASSPSGQGARTGELFF	EIYKRWII	1
CASSPAGSYTEAFF	EIYKRWII	1
CASSLTAGARVWQFF	EIYKRWII	1
CSVRQGYEQYF	EIYKRWII	1
CASSVLGGNYGYTF	EIYKRWII	1
CASSYLWGQYEQYF	EIYKRWII	1
CASSFLEDGYTF	EIYKRWII	1
CASRGLAGGDTQYF	EIYKRWII	1
CASSVLGGRTGELFF	EIYKRWII	1
CASSEVGSKSRQGAYEQYF	EIYKRWII	1
CASSTPGRRTSNQPQHF	EIYKRWII	1
CASSLNGFRGDTEAFF	EIYKRWII	1
CASSQDRRDTYTYEQYF	EIYKRWII	1
CASSFQGERTEAFF	EIYKRWII	1
CASRNRAAGRFRETQYF	EIYKRWII	1
CASSLIPGNQPQHF	EIYKRWII	1
CASSLDDGRRPLHF	EIYKRWII	1
CASSEASPGRSYGYTF	EIYKRWII	1
CASSMLDGGRDEQFF	EIYKRWII	1
CSARWDYEQYF	EIYKRWII	1
CASSPLTSGGARDTQYF	EIYKRWII	1
CASSPTGTGVRNTEAFF	EIYKRWII	1
CSARENYEQYF	EIYKRWII	1
CASSQSPTRLAGTPHNEQFF	EIYKRWII	1
CASSLDLNRERTGELFF	EIYKRWII	1
CASGGQGDRQPQHF	EIYKRWII	1
CASSLVEIRNEQFF	EIYKRWII	1
CASSVLAGLGNEQFF	FLKEKGGL	1
CASSLLAGLTDTQYF	FLKEKGGL	1
CASSHSPGTSGSPGVTQYF	FLKEKGGL	1
CASSQGQGIALYGYTF	FLKEKGGL	1
CASSPNSGRVTGELFF	FLKEKGGL	1
CASSLGQGLVLSGYTF	FLKEKGGL	1
CSARDRGRALNEQFF	FLKEKGGL	1
CASSFLHPSTEAFF	FLKEKGGL	1
CASRDFPSGGSYEQYF	FLKEKGGL	1
CASTYTGGAGGELFF	FLKEKGGL	1
CASRYLRGEGAHPSNTEAFF	FLKEKGGL	1
CASSTLASGRYEQYF	FLKEKGGL	1
CASSPIEGLAKNIQYF	FLKEKGGL	1
CASSLMESVWVEQFF	FLKEKGGL	1
CASSEFGQGFYEQYF	FLKEKGGL	1
CASSQWGLPTDTQYF	FLKEKGGL	1
CASSEFPAGVYEQFF	FLKEKGGL	1
CASSLGDLYTGELFF	FLKEKGGL	1
CASSYLAGQGAPYSNQPQHF	FLKEKGGL	1
CASSDSGAGTPNGYTF	FLKEKGGL	1
CASRVGQGVVGELFF	FLKEKGGL	1
CASGVLREAFF	FLKEKGGL	1
CASSLDHQAGHEQYF	FLKEKGGL	1
CASSYQTGTGTYGYTF	FLKEKGGL	1
CASSLLDRVREDTQYF	FLKEKGGL	1
CSARDHLRANEKLFF	FLKEKGGL	1
CASSELAGLGTEAFF	FLKEKGGL	1
CASSWGIGSQQETQYF	FLKEKGGL	1
CASSLPTALTGELFF	EIYKRWII	1
CASSLIDGARDEQFF	EIYKRWII	1
CASSLSRDRNEQFF	EIYKRWII	1
CSGGPLETQYF	EIYKRWII	1
CASSVGGDARETQYF	EIYKRWII	1
CASSASTKDTQYF	EIYKRWII	1
CASSKEHRGTEDYEQYF	EIYKRWII	1
CASSPGRTSHEQFF	KRWIILGLNK	1
CASSWDRNEQFF	KRWIILGLNK	1
CASSQGAGGIEQFF	KRWIILGLNK	1
CATSMGQTTYEQYF	KRWIILGLNK	1
CASSQGRGDYGYTF	KRWIILGLNK	1
CASSQEWSYEQYF	FLKEKGGL	1
CASTVARDGGELFF	FLKEKGGL	1
CASSYGLNTEAFF	FLKEKGGL	1
CASSSLGGGRGINSPLHF	FLKEKGGL	1
CASSLAPGTSGSPYNEQFF	FLKEKGGL	1
CATKGTGLYNEQFF	FLKEKGGL	1
CASSLRGGGASYNEQFF	ISPRTLNAW	1
CASSPWTYGTGTLNEKLFF	ISPRTLNAW	1
CASSLKLADEQFF	ISPRTLNAW	1
CASSQDGLLNSYEQYF	ISPRTLNAW	1
CASGLGRGWNTEAFF	ISPRTLNAW	1
CASGTKYYGYTF	QASQEVKNW	1
CASSSQGYGRAQHF	QASQEVKNW	1
CASSHGQGMKTQYF	ISPRTLNAW	1
CSALQLGGAGANEQFF	ISPRTLNAW	1
CASTYDRGFTGELFF	ISPRTLNAW	1
CASSMTYGYTF	KAFSPEVIPMF	1
CASSGSYGYTF	KAFSPEVIPMF	1
CASSLMSGTDTQYF	KAFSPEVIPMF	1
CASSDRSQYGYTF	KAFSPEVIPMF	1
CASSQDPSGNPMETQYF	ISPRTLNAW	1
CASTQGRGGSGYTF	QASQEVKNW	1
CASSLRRDSGPPSNQPQHF	KAFSPEVIPMF	1
CATTGQDYGYTF	KAFSPEVIPMF	1
CASSLLGTVGNQPQHF	KAFSPEVIPMF	1
CASSGTDYGYTF	KAFSPEVIPMF	1
CAQGGSNYGYTF	KAFSPEVIPMF	1
CASSSERPSNEQYF	KAFSPEVIPMF	1
CASSPGQGFKTQYF	KAFSPEVIPMF	1
CASSPGQGGYEQYF	KAFSPEVIPMF	1
CASSYGQAGEQYF	KAFSPEVIPMF	1
CASTGQGYGYTF	KAFSPEVIPMF	1
CAEGGRDYGYTF	KAFSPEVIPMF	1
CASSGRNEQFF	KAFSPEVIPMF	1
CASSLGDRAFRNIQYF	KAFSPEVIPMF	1
CASSQETPRGPPLAKNIQYF	KAFSPEVIPMF	1
CASSISYEQYF	KAFSPEVIPMF	1
CATTGGNYGYTF	KAFSPEVIPMF	1
CASSPWGDGTDTQYF	KAFSPEVIPMF	1
CASSAPDSQETQYF	KAFSPEVIPMF	1
CASSFGTGGVGELFF	ISPRTLNAW	1
CASSSATGITGELFF	ISPRTLNAW	1
CASSARQGSRTDTQYF	ISPRTLNAW	1
CASSQATGNTGELFF	ISPRTLNAW	1
CASSAGQGWKEQYF	ISPRTLNAW	1
CASSGTQVQPQHF	ISPRTLNAW	1
CASNAGQGWKEQYF	ISPRTLNAW	1
CASSAGQGWKGQYF	ISPRTLNAW	1
CASSLIWDRGNYGYTF	KAFSPEVIPMF	1
CASSGSGTGYGYTF	KAFSPEVIPMF	1
CASSLMQGTDTQYF	KAFSPEVIPMF	1
CSTGTYGYTF	KAFSPEVIPMF	1
CATSDPNRDTDTQYF	KAFSPEVIPMF	1
CASSRYEQYF	ISPRTLNAW	1
CASFLNTEAFF	ISPRTLNAW	1
CASSGTYGYTF	KAFSPEVIPMF	1
CASSDPGQYGYTF	KAFSPEVIPMF	1
CASSLVNGLGYTF	SMGVTYEM	1
CASSLVNGLGYTF	YMGVSYEM	1
CASSLVNGLGYTF	YMGVVYEM	1
CASSLVNGLGYTF	KMGVTYEM	1
CASSLVNGLGYTF	FMGVTYEM	1
CASSRDTVNTEAFF	LMDMHNGQL	1
CASSRDTVNTEAFF	RLDAMNGQL	1
CASSRDTVNTEAFF	RMDYNNMQM	1
CASSRDTVNTEAFF	GMDYHNGHL	1
CASSRDTVNTEAFF	KMDYFSGQL	1
CASSRDTVNTEAFF	SMDWFQGQM	1
CASSRDTVNTEAFF	LMDYWQGQL	1
CASSRDTVNTEAFF	NMMWFQGQL	1
CASSRDTVNTEAFF	VLDLFQGQL	1
CASSRDTVNTEAFF	MMDFFNAQM	1
CASSRDFVSNEQYF	TMDFYQGQL	1
CASSRDFVSNEQYF	KMDYFSGQL	1
CASSRDFVSNEQYF	SMDWFQGQM	1
CASSRDFVSNEQYF	LMDYWQGQL	1
CASSRDFVSNEQYF	NMMWFQGQL	1
CASSRDFVSNEQYF	MMDFFNAQM	1
CASSPSGLAGSNLGNEQFF	RMEQVDWTV	1
CASSPSGLAGSNLGNEQFF	KLEFMDWRL	1
CASSPSGLAGSNLGNEQFF	WLDNFELCL	1
CASSPSGLAGSNLGNEQFF	TLEYMDWLV	1
CASSPSGLAGSNLGNEQFF	EMMLFDWKV	1
CASSPSGLAGSNLGNEQFF	KLEQLDWTV	1
CASSPSGLAGSNLGNEQFF	TMETIDWKV	1
CASSPSGLAGSNLGNEQFF	TLEELDWCL	1
CASSPSGLAGSNLGNEQFF	LLEDLDWDV	1
CASSPSGLAGSNLGNEQFF	VLEEVDWLI	1
CASSPSGLAGSNLGNEQFF	NMEYMTWDV	1
CASSPSGLAGSNLGNEQFF	NVEYYDIKL	1
CASSPGALNTEAFF	ELAGIGILTV	1
CASSPAALSGAYEQYF	ELAGIGILTV	1
CASSRRSSGELFF	ELAGIGILTV	1
CASSFQGLGQPQHF	ELAGIGILTV	1
CASSRDSALWISTDTQYF	ELAGIGILTV	1
CSASETGVGQPQHF	EAAGIGILTV	1
CASSQQGLGQPQHF	EAAGIGILTV	1
CSVSDLGVGQPQHF	EAAGIGILTV	1
CASSQGDWGGSQPQHF	EAAGIGILTV	1
CASSRDSALWISTDTQYF	EAAGIGILTV	1
CASRLGTGPEAFF	EAAGIGILTV	1
CASSFGLGTEAFF	EAAGIGILTV	1
CASSLSNEGNEQYF	EAAGIGILTV	1
CASSPPGLSGNIQYF	ELAGIGILTV	1
CASSPGTLADTQYF	ELAGIGILTV	1
CASAWGGMTNEQYF	ELAGIGILTV	1
CASSETGGTEAFF	EAAGIGILTV	1
CASSDQGLGTEAFF	EAAGIGILTV	1
CASSLGDVDEYF	EAAGIGILTV	1
CASRSLGQGAEKLFF	ELAGIGILTV	1
CASSRGTLHYGYTF	FYGKTILWF	1
CASSLGQGCSNQPQHF	FYGKTILWF	1
CASSLGAAPQETQYF	FYGKTILWF	1
CASSTRVVAGNNEQFF	FYGKTILWF	1
CASSPGVGTEAFF	EFTVSGNIL	1
CASSPGASYEQYF	ESITGSLGPLL	1
CASSLPLGYEQYF	LAMPFATPM	1
CASSQDSHSTSTDTQYF	KASEKIFYV	1
CASSALFSGANVLTF	KASEKIFYV	1
CASSLLPEGTGRVSGYTF	VYFFLPDHL	1
CATSSFRMTGDNSPLHF	KASEKIFYV	1
CASSWEYEQYF	KASEKIFYV	1
CSANPRTTLYEQYF	MEVDPIGHLY	1
CATSSEDSSNQPQHF	HRRGSRSYV	1
CASSSSYSNQPQHF	APRGPHGGAASGL	1
CASSLASGSNQPQHF	RVRFFFPSL	1
CASSESQGDYYGYTF	VLNGTVHPV	1
CASSPHAGGVDEKLFF	EEAAGIGIL	1
CASSHHSGGIYNEQFF	FQDYIKSYL	1
CASSLMGGGNTIYF	RYGSFSVTL	1
CASSIEFDRGAPTEQYF	ELAGIGILTV	1
CASSYRGQSNQPQHF	ELAGIGILTV	1
CASRWGQLTNYGYTF	ELAGIGILTV	1
CASRYQGLGQPQHF	ELAGIGILTV	1
CASSWSQLVHEQFF	ELAGIGILTV	1
CSAPDTGLGQPQHF	ELAGIGILTV	1
CASRDGTLSYNEQFF	ELAGIGILTV	1
CASSQGQLSSYNEQFF	ELAGIGILTV	1
CASSIAAVSLANYGYTF	ELAGIGILTV	1
CASSPGQGSPLHF	ELAGIGILTV	1
CASSLLGGLEAFF	ELAGIGILTV	1
CASSFRGQNTEAFF	ELAGIGILTV	1
CASSQYEVQETQYF	ELAGIGILTV	1
CASSHQGVGQPQHF	ELAGIGILTV	1
CASSGQGMGYTF	ELAGIGILTV	1
CASTLTGLGQPQHF	ELAGIGILTV	1
CASIWAGLGQPQHF	ELAGIGILTV	1
CASSLQGMGQPQHF	ELAGIGILTV	1
CASSKPSGINEQFF	ELAGIGILTV	1
CSARSRGGGIETQYF	ELAGIGILTV	1
CASSVWADPNEAFF	ELAGIGILTV	1
CASRLATLVGNEQFF	ELAGIGILTV	1
CASRSGSLNTEAFF	ELAGIGILTV	1
CASSLTTPPSTDTQYF	ELAGIGILTV	1
CASRQQGLGSPLHF	ELAGIGILTV	1
CASQSGFLSNSPLHF	ELAGIGILTV	1
CASSYGDLYTGELFF	ELAGIGILTV	1
CASSLAGLADNEQFF	ELAGIGILTV	1
CASSLAWALQDEQYF	ELAGIGILTV	1
CAWSVQGLGYGYTF	ELAGIGILTV	1
CASSATGADQPQHF	ELAGIGILTV	1
CASSDYSNQPQHF	ELAGIGILTV	1
CSARAGNQPQHF	ELAGIGILTV	1
CSARAGAETQYF	ELAGIGILTV	1
CASTPPGSETQYF	ELAGIGILTV	1
CASSENQLMNTEAFF	ELAGIGILTV	1
CATSDQGGTEDEQFF	ELAGIGILTV	1
CAWSGGGGRVHEQYF	ELAGIGILTV	1
CAWSVPGLGQPQHF	ELAGIGILTV	1
CASSLQGLGTEAFF	ELAGIGILTV	1
CASSQQGLGTEAFF	ELAGIGILTV	1
CASSVQGLGQPQHF	ELAGIGILTV	1
CATSDSRQINTGELFF	ELAGIGILTV	1
CASSEGMGQPQHF	ELAGIGILTV	1
CASTYTSLAHNEQFF	ELAGIGILTV	1
CASSPGVLANEQYF	ELAGIGILTV	1
CATAPREDRVGNEAFF	ELAGIGILTV	1
CAILGQGYGYTF	APRGPHGGAASGL	1
CASSYGGGPEAFF	ELAGIGILTV	1
CASSFAANYEQYF	ELAGIGILTV	1
CASSFTGLGQPQHF	ELAGIGILTV	1
CASSLLPSGETQYF	ELAGIGILTV	1
CASSLGPSVYEQYF	ELAGIGILTV	1
CASSQGVLAGEQFF	ELAGIGILTV	1
CASSYGHFGSYGYTF	EAAGIGILTV	1
CASSLSTGFQETQYF	EAAGIGILTV	1
CASSITPLGGDGYTF	EAAGIGILTV	1
CASSYGAQGSYGYTF	EAAGIGILTV	1
CASSDDRGFDTGELFF	EAAGIGILTV	1
CASSSFLMTGLNEQFF	EAAGIGILTV	1
CASSGLGSGQPYEQYF	EAAGIGILTV	1
CASSQDELAASTDTQYF	EAAGIGILTV	1
CASSVGQSQPQHF	ELAGIGILTV	1
CASSSTGVGQPQHF	ELAGIGILTV	1
CASSMTGLGQPQHF	ELAGIGILTV	1
CSASVPGLGQPQHF	ELAGIGILTV	1
CASSQQGLGQPQHF	ELAGIGILTV	1
CASSLQGLGQPQHF	EAAGIGILTV	1
CASSFTGTFSYEQYF	EAAGIGILTV	1
CASSLDAASVHYEQFF	EAAGIGILTV	1
CASSFGEGLVYNEQFF	ELAGIGILTV	1
CASRDPGGGGYEKLFF	ELAGIGILTV	1
CASSQEALGGRVDTQYF	ELAGIGILTV	1
CASPATGSNQPQHF	ELAGIGILTV	1
CASSDSTASSEQFF	ELAGIGILTV	1
CASSPSQGGNTEAFF	ELAGIGILTV	1
CASSFSSGSPHEQFF	ELAGIGILTV	1
CASSSSGTSGVYEQYF	ELAGIGILTV	1
CASSSTSGAQGDTQYF	ELAGIGILTV	1
CASSFGGLGTEAFF	ELAGIGILTV	1
CASSLSSLIVDTQYF	ELAGIGILTV	1
CASSPGTLSDTQYF	ELAGIGILTV	1
CASSQDRGGAETQYF	ELAGIGILTV	1
CRPGPLAGYGYTF	ELAGIGILTV	1
CSARDGLGELFF	ELAGIGILTV	1
CSARAGVGGDTQYF	ELAGIGILTV	1
CSAPRAGVGQPQHF	ELAGIGILTV	1
CASSGQGVGNEQFF	ELAGIGILTV	1
CASSRSPDTQYF	ELAGIGILTV	1
CASRMIGYEQYF	ELAGIGILTV	1
CASSDPTSPNEQFF	ELAGIGILTV	1
CASALPGPITGSEAFF	ELAGIGILTV	1
CASSTRDRGYEQYF	ELAGIGILTV	1
CASSQEGGAFVDTQYF	ELAGIGILTV	1
CASSLGAGIVETQYF	ELAGIGILTV	1
CASSLLGGSTDTQYF	ELAGIGILTV	1
CASASAQLGNTIYF	ELAGIGILTV	1
CASSLLGPGQPQHF	ELAGIGILTV	1
CASSERAGELFF	ELAGIGILTV	1
CSARDREDEKLFF	ELAGIGILTV	1
CASSFGGSQPQHF	ELAGIGILTV	1
CASTLGQGQPQHF	ELAGIGILTV	1
CASSYSTGDGVHF	ELAGIGILTV	1
CATSVSANTGELFF	ELAGIGILTV	1
CASSQEAGGETQYF	ELAGIGILTV	1
CASSLMASFETQYF	ELAGIGILTV	1
CASRGLAGAGEQYF	ELAGIGILTV	1
CASSYLGSGNEQFF	ELAGIGILTV	1
CASSPGLAYYEQYF	ELAGIGILTV	1
CASTPGPRDSPLHF	ELAGIGILTV	1
CASSLLQGSDTQYF	ELAGIGILTV	1
CASSRGQGIDTQYF	ELAGIGILTV	1
CASSPEQGGQPQHF	ELAGIGILTV	1
CASSYDTLGTEAFF	ELAGIGILTV	1
CSASSGGAGVDTQYF	ELAGIGILTV	1
CASSVGGGNTGELFF	ELAGIGILTV	1
CASRLPGLSLNEQYF	ELAGIGILTV	1
CASSQESLAGNEQFF	ELAGIGILTV	1
CASSQVGMTTGELFF	ELAGIGILTV	1
CASSLMTAVYNSPLHF	ELAGIGILTV	1
CSARDQLGLNTGELFF	ELAGIGILTV	1
CASSQIQGAVAGELFF	ELAGIGILTV	1
CAISESQVGVANTEAFF	ELAGIGILTV	1
CASSSAGGPHLRDEQFF	ELAGIGILTV	1
CASSPQRTSGRADEQFF	ELAGIGILTV	1
CASSLSGVTGVASYGYTF	ELAGIGILTV	1
CASSFAALPGETEAFF	ELAGIGILTV	1
CASSQAHGLFSYEQYF	ELAGIGILTV	1
CASSLGRYNEQFF	YLEPGPVTA	1
CASSLGSSYEQYF	YLEPGPVTA	1
CASSFIGGTDTQYF	YLEPGPVTA	1
CASSIGGPYEQYF	YLEPGPVTA	1
CASSHSRGSGNTIYF	HSKKKCDEL	1
CASSQSRGSGNTIYF	HSKKKCDEL	1
CASSQGPPGLAQETQYF	HSKKKCDEL	1
CASSQGPPGTTRETQYF	HSKKKCDEL	1
CASSRLTVDRSDTGELFF	HSKKKCDEL	1
CASSPRQGGTGELFF	HSKKKCDEL	1
CASSSRQGGTGELFF	HSKKKCDEL	1
CASSHRQGGTGELFF	HSKKKCDEL	1
CASSNRQGGTGELFF	HSKKKCDEL	1
CASSPGPQRGGLETQYF	HSKKKCDEL	1
CAISETDKLGFF	HSKKKCDEL	1
CAIRTGGDEQFF	HSKKKCDEL	1
CAIRAGGDEQFF	HSKKKCDEL	1
CAISGGSGDNEQFF	HSKKKCDEL	1
CAISGGVRSYNEQFF	HSKKKCDEL	1
CAISSGTKSTEAFF	HSKKKCDEL	1
CAISEVQETQYF	HSKKKCDEL	1
CAISERHLTDTQYF	HSKKKCDEL	1
CAISESTGPGGDTQYF	HSKKKCDEL	1
CAISVSGRSTDTQYF	HSKKKCDEL	1
CAIRTRTGESYTF	HSKKKCDEL	1
CAIRTRIGETQYF	HSKKKCDEL	1
CAVRLMENYGYTF	HSKKKCDEL	1
CAISGMGQRDNEQFF	HSKKKCDEL	1
CAISDEGRNTEAFF	HSKKKCDEL	1
CASSRRGRDDEKLFF	HSKKKCDEL	1
CASSRRQGAMRETQYF	HSKKKCDEL	1
CASSRRGATTSTDTQYF	HSKKKCDEL	1
CASSRRGAATSTDTQYF	HSKKKCDEL	1
CAISESQGNTEAFF	ATDALMTGY	1
CAISEDRALVSYTF	ATDALMTGY	1
CAISEDRALNEQFF	ATDALMTGY	1
CAVQPGQGMQPQHF	ATDALMTGY	1
CAISDGTVNNQPQHF	ATDALMTGY	1
CAISEGAMGNQPQHF	ATDALMTGY	1
CAISEEGIGNQPQHF	ATDALMTGY	1
CAAADEEIGNQPQHF	ATDALMTGY	1
CAIGDDRAGNQPQHF	ATDALMTGY	1
CAISDQTSGNQPQHF	ATDALMTGY	1
CAISDAGAGNQPQHF	ATDALMTGY	1
CAISEGTGGHQPQHF	ATDALMTGY	1
CAISESTVGNQPQHF	ATDALMTGY	1
CAISESATGYQPQHF	ATDALMTGY	1
CAISESSAGNQPQHF	ATDALMTGY	1
CAISESSIGNQPQHF	ATDALMTGY	1
CAISESSSGNQPQHF	ATDALMTGY	1
CAISESSSGSNEQFF	ATDALMTGY	1
CAISDSSSGSNEQFF	ATDALMTGY	1
CAISESSSGANVLTF	ATDALMTGY	1
CAISESASGSNEQYF	ATDALMTGY	1
CAISESTAGNNEQFF	ATDALMTGY	1
CAIRSGTINTGELFF	ATDALMTGY	1
CAIGTGTISTETQYF	ATDALMTGY	1
CAISEGTVGFDEQYF	ATDALMTGY	1
CAISEGVSGGYNEQFF	ATDALMTGY	1
CASSPGDTGANVLTF	ATDALMTGY	1
CASSSTDTGANVLTF	ATDALMTGY	1
CASSSGATGANVLTF	ATDALMTGY	1
CASSSIATGANVLTF	ATDALMTGY	1
CASSSGTIGANVLTF	ATDALMTGY	1
CASSSGVSGANVLTF	ATDALMTGY	1
CASSFTTMGNQPQHF	ATDALMTGY	1
CASQGGEIGNNEQFF	ATDALMTGY	1
CASSLRQGGLTEAFF	ATDALMTGY	1
CASGGRGGGETQYF	ATDALMTGY	1
CASSPRVVGSETQYF	ATDALMTGY	1
CASKNRDVGYNEQFF	ATDALMTGY	1
CASSLRPQLGETQYF	ATDALMTGY	1
CASSFLAGFTDTQYF	ATDALMTGY	1
CASSPISISSGLPEYF	ATDALMTGY	1
CASSSSISGMRPRIYEQYF	ATDALMTGY	1
CASSMGTGAHEQYF	ATDALMTGY	1
CASSPREIGNQPQHF	ATDALMTGY	1
CATTVGVIGNQPQHF	ATDALMTGY	1
CASTTGTIGNQPQHF	ATDALMTGY	1
CASIDRTIGNQPQHF	ATDALMTGY	1
CASSIRDAGNQPQHF	ATDALMTGY	1
CATRGTVINTGELFF	ATDALMTGY	1
CASTPDLSSYNEQFF	ATDALMTGY	1
CASSIRHSEYTDTQYF	ATDALMTGY	1
CASRALDITLGNVLTF	ATDALMTGY	1
CASILRDFSSGNTIYF	ATDALMTGY	1
CASSIGGWRAEATNEKLFF	ATDALMTGY	1
CASSVVGGVDEQFF	ATDALMTGY	1
CASGSQGSTDTQYF	ATDALMTGY	1
CASSLPDINTGELFF	ATDALMTGY	1
CASRGGTINTGELFF	ATDALMTGY	1
CASSAGTINTGELFF	ATDALMTGY	1
CASSSGTINTGELFF	ATDALMTGY	1
CASSSGTVNTGELFF	ATDALMTGY	1
CASEAGTVNTNTQYF	ATDALMTGY	1
CASSVATVMTGELFF	ATDALMTGY	1
CASSTGTSNTGELFF	ATDALMTGY	1
CASSVATLNTGELFF	ATDALMTGY	1
CASSVAETNTGELFF	ATDALMTGY	1
CASSSGVTNTGELFF	ATDALMTGY	1
CASTAPATNTGELFF	ATDALMTGY	1
CASMSRDLNTGELFF	ATDALMTGY	1
CASSSPASSTDTQYF	ATDALMTGY	1
CASRETYEQYF	ATDALMTGY	1
CASRDTYEQYF	ATDALMTGY	1
CASSERRYTGELFF	ATDALMTGY	1
CASSGGTASTDTQYF	ATDALMTGY	1
CASSDGTANNQPQHF	ATDALMTGY	1
CASRSGTSNTGELFF	ATDALMTGY	1
CASRSGDTNTGELFF	ATDALMTGY	1
CASRTGTSNTGELFF	ATDALMTGY	1
CASRAGTSNTGELFF	ATDALMTGY	1
CASRTGISNTGELFF	ATDALMTGY	1
CASRTGTINTGELFF	ATDALMTGY	1
CARSRGGINTGELFF	ATDALMTGY	1
CASSEGNGGINIQYF	ATDALMTGY	1
CASRDILTSYNEQFF	ATDALMTGY	1
CASSEAVISYNEQFF	ATDALMTGY	1
CASSEYPGPGANVLTF	ATDALMTGY	1
CASSDPDLLISTDTQYF	ATDALMTGY	1
CASSGDRDAGSSYEQYF	ATDALMTGY	1
CASSTGGSGNFSYEQYF	ATDALMTGY	1
CASSLSSHYGYTF	ATDALMTGY	1
CASSLTTGYGYTF	ATDALMTGY	1
CASSEVGLLNEQFF	ATDALMTGY	1
CASSLVGGAGEQFF	ATDALMTGY	1
CASRPSGQLDEQFF	ATDALMTGY	1
CASSPSGQLDEQFF	ATDALMTGY	1
CASSQSGQLDTQYF	ATDALMTGY	1
CASSSLGQLETQYF	ATDALMTGY	1
CASSLLGQLYEQYF	ATDALMTGY	1
CASNPAGQLETQYF	ATDALMTGY	1
CASSQTGQLDEQYF	ATDALMTGY	1
CASSPTGQLETQYF	ATDALMTGY	1
CASRPTGQLETQYF	ATDALMTGY	1
CASSPSGQLETQYF	ATDALMTGY	1
CASSLVGQLETQYF	ATDALMTGY	1
CASSLVGQLDEQYF	ATDALMTGY	1
CASSEVGQLETQYF	ATDALMTGY	1
CASSFSGQLDTIYF	ATDALMTGY	1
CASSPDPGQLYEQYF	ATDALMTGY	1
CASSPFGTGPYEQYF	ATDALMTGY	1
CASSLGTGPSYEQYF	ATDALMTGY	1
CASSPSTANTQPQHF	ATDALMTGY	1
CASSLMQGQGRNGYTF	ATDALMTGY	1
CASSLGLAGGEETQYF	ATDALMTGY	1
CASRHQLAQSSYNEQFF	ATDALMTGY	1
CASSYVGQLDEQFF	ATDALMTGY	1
CASSYRGQLNEQFF	ATDALMTGY	1
CASSSRGQLDTQYF	ATDALMTGY	1
CASSSSGQLDEQFF	ATDALMTGY	1
CASSLSGQLDEQFF	ATDALMTGY	1
CASSLSGQLDEQYF	ATDALMTGY	1
CASSLSGQLDTQYF	ATDALMTGY	1
CASSLVGQLYEQYF	ATDALMTGY	1
CASSEAGQLNEQFF	ATDALMTGY	1
CASRWTGQLDEQFF	ATDALMTGY	1
CASSLLAGGWDEQFF	ATDALMTGY	1
CASSPLEAEAKNIQYF	ATDALMTGY	1
CASSLDLGDRGGYGYTF	ATDALMTGY	1
CASSHLLGVLAGGTDTQYF	ATDALMTGY	1
CASSSHVGGGGASIDTQYF	ATDALMTGY	1
CASSLAPLAGGAFSYNEQFF	ATDALMTGY	1
CASSSILGQGEHPVTDTQYF	ATDALMTGY	1
CSARVMVGGTEAFF	NLVPMVATV	1
CASSLEYSPRPYEQYF	NLVPMVATV	1
CATSTVGVGTGFPPSFF	NLVPMVATV	1
CASSFGGTGNQPQHF	NLVPMVATV	1
CASSPQTGTIYGYTF	NLVPMVATV	1
CASSPGTSGRAWNNEQFF	NLVPMVATV	1
CASSLLAVGTGGNTEAFF	NLVPMVATV	1
CASSLTTLAGVPYEQFF	NLVPMVATV	1
CASSLLLAGYNEQFF	NLVPMVATV	1
CASSQEEGRVDGYTF	NLVPMVATV	1
CAWTISDLAKNIQYF	NLVPMVATV	1
CASSPGTDYYGYTF	NLVPMVATV	1
CASSYGTGDSNQPQHF	NLVPMVATV	1
CASSRRDATRFAETQYF	NLVPMVATV	1
CASSVVTEAFF	NLVPMVATV	1
CASSPGDEQFF	CRVLCCYVL	1
CASTPGDEQFF	CRVLCCYVL	1
CASSAGDEQYF	CRVLCCYVL	1
CASSPGDEQYF	CRVLCCYVL	1
CASSPGDTQYF	CRVLCCYVL	1
CASTHGDEQFF	CRVLCCYVL	1
CASTPGDEQYF	CRVLCCYVL	1
CASTQGDEQFF	CRVLCCYVL	1
CASTSGDEQFF	CRVLCCYVL	1
CASTTGDEQFF	CRVLCCYVL	1
CATSPGDEQYF	CRVLCCYVL	1
CASTLGDEQYF	CRVLCCYVL	1
CAVTAGDEQFF	CRVLCCYVL	1
CASSPISNEQFF	CRVLCCYVL	1
CASSPVSNEQFF	CRVLCCYVL	1
CASSPISNEQYF	CRVLCCYVL	1
CASSPGTPRDEQFF	CRVLCCYVL	1
CASSQGTPRDEQYF	CRVLCCYVL	1
CASSSGQKNTEAFF	CRVLCCYVL	1
CASSTGQKNTEAFF	CRVLCCYVL	1
CASTPGQKNTEAFF	CRVLCCYVL	1
CASTTGQKNTEAFF	CRVLCCYVL	1
CATTSGQKNTEAFF	CRVLCCYVL	1
CASQPGQKNTEAFF	CRVLCCYVL	1
CASSSGLTNTEAFF	CRVLCCYVL	1
CSAPDWNNEQFF	CRVLCCYVL	1
CSAPDWGNEQFF	CRVLCCYVL	1
CSAPNWFNEQFF	CRVLCCYVL	1
CSAPTWDNEQFF	CRVLCCYVL	1
CASSFPDTQYF	CRVLCCYVL	1
CASTPWGAEAFF	CRVLCCYVL	1
CATSRTGGETQYF	FRCPRRFCF	1
CATSREGGETQYF	FRCPRRFCF	1
CATSAEGGETQYF	FRCPRRFCF	1
CATSGTAGETQYF	FRCPRRFCF	1
CATSRDAGETQYF	FRCPRRFCF	1
CATSRDGGETQYF	FRCPRRFCF	1
CATSRVAGETQYF	FRCPRRFCF	1
CATSVTGGETQYF	FRCPRRFCF	1
CASSGGLEAFF	FRCPRRFCF	1
CASSLGLEAFF	FRCPRRFCF	1
CASSPQRNTEAFF	RPHERNGFTVL	1
CASSPARNTEAFF	RPHERNGFTVL	1
CASSPSRNTEAFF	RPHERNGFTVL	1
CASSPHRNTEAFF	RPHERNGFTVL	1
CASSPNRNTEAFF	RPHERNGFTVL	1
CASSPGRNTEAFF	RPHERNGFTVL	1
CASSPTRNTEAFF	RPHERNGFTVL	1
CASSFRTVSSYEQYF	TPRVTGGGAM	1
CASSFRTVNSYEQYF	TPRVTGGGAM	1
CASSLRTVSSYEQYF	TPRVTGGGAM	1
CASSLKGVSSYNEQFF	TPRVTGGGAM	1
CASSFRQGVNTGELFF	TPRVTGGGAM	1
CASSFRQGSNTGELFF	TPRVTGGGAM	1
CASSFRSGINTGELFF	TPRVTGGGAM	1
CASSFRQGTPTGELFF	TPRVTGGGAM	1
CASSSRGTVNTEAFF	TPRVTGGGAM	1
CASSLHTQGARTEAFF	TPRVTGGGAM	1
CASSLHSRGARTEAFF	TPRVTGGGAM	1
CASIPDRVTEAFF	SFHSLHLLF	1
CASSSRTGGRNTEAFF	SFHSLHLLF	1
CASSQDRGAVYGYTF	SFHSLHLLF	1
CASSLMVDEYF	SFHSLHLLF	1
CASSPDRAQTQYF	SFHSLHLLF	1
CASSLDRGNIQYF	SFHSLHLLF	1
CASRPNRDSNYGYTF	SFHSLHLLF	1
CASSPPRGRENEQFF	SFHSLHLLF	1
CASRGWGGPSEQYF	SFHSLHLLF	1
CASRPDRGNTQYF	SFHSLHLLF	1
CASSVTGTGKWEQYF	SFHSLHLLF	1
CASSAGQGVTYEQYF	SFHSLHLLF	1
CASSQDGVRMEGYTF	SFHSLHLLF	1
CASSPDRGLEQYF	SFHSLHLLF	1
CASSPGTSGNTGELFF	SFHSLHLLF	1
CASSLRGNEGFYNEQFF	SFHSLHLLF	1
CASSVRGSPLHF	SFHSLHLLF	1
CAFKRDRENEQFF	SFHSLHLLF	1
CATFRDRDTGELFF	SFHSLHLLF	1
CAPTPKTGSETQYF	SFHSLHLLF	1
CASMPDRKNTIYF	SFHSLHLLF	1
CASIPDREGNIQYF	SFHSLHLLF	1
CASIEDRTPEAFF	SFHSLHLLF	1
CASSQRSGQGNSPLHF	SFHSLHLLF	1
CASSQDRGYVYGYTF	SFHSLHLLF	1
CASSPDRELTQYF	SFHSLHLLF	1
CSVEDLRSGGGDTEAFF	SFHSLHLLF	1
CASSSSTSGNTGELFF	SFHSLHLLF	1
CASSPDRLQTQYF	SFHSLHLLF	1
CASIPDRNTEAFF	SFHSLHLLF	1
CASSHPAGNFHGYTF	SFHSLHLLF	1
CASSFFHPIWGMSSETQYF	SFHSLHLLF	1
CASSLDVPGPYEQYF	SFHSLHLLF	1
CASSLGPGGAYEQYF	SFHSLHLLF	1
CASRPDRSHEQYF	SFHSLHLLF	1
CASSVPRTDTQYF	SFHSLHLLF	1
CAINRDRESDQYF	SFHSLHLLF	1
CASIPDREKTQYF	SFHSLHLLF	1
CASKVDREGTIYF	SFHSLHLLF	1
CASSPDRAHTIYF	SFHSLHLLF	1
CASSPPRLRDIQYF	SFHSLHLLF	1
CASSPDRRIYEQYF	SFHSLHLLF	1
CASSQVAGASFNEQFF	SFHSLHLLF	1
CASLPDRSSHEQYF	SFHSLHLLF	1
CASKEDRQSNSPLHF	SFHSLHLLF	1
CASSVGGGVTDTQYF	MVNTVAGAMK	1
CASNLGGGSTDTQYF	SSCMGGMNWR	1
CASSFGSGSTDTQYF	SSCMGGMNWR	1
CASSLGTGSTDTQYF	SSCMGGMNWR	1
CASSSPRSSRDTDTQYF	VLLGVKLFGV	1
CASSLDRKAFF	TLWCSPIKV	1
CASRAVINTDTQYF	APARLERRHSA	1
CASSLDFSRQETQYF	WLIRETQPITK	1
CASSLYLASNTGELFF	WLIRETQPITK	1
CASSDRNTNYGYTF	GLLDEDFYA	1
CASSMRVQSNTGELFF	GLLDEDFYA	1
CASSPGREQYF	HQNPVTGLLL	1
CASRDGRVHQPQHF	APARLERRHSA	1
CASSLSWGSSYNEQFF	RVSTLRVSL	1
CASRDHRVIYGYTF	SYMIMEIE	1
CASSRSTGGSGNTIYF	GEEDGAGGHSL	1
CASSQAGGTGELFF	GEEDGAGGHSL	1
CASSSTGADSHEQFF	RHDLPPYRVYL	1
CASSLLKAANYGYTF	APARLERRHSA	1
CASRPWTGANEKLFF	MPYGYVLNEF	1
CASSLDREDEQYF	TYDTVHRHL	1
CASSANRGPDTEAFF	FGDVGSTLF	1
CASSVGNGASTDTQYF	FRNEGIHL	1
CASSLYRGKETQYF	RILLVAASY	1
CASRTDRFLGAFF	YLSFYTAEQL	1
CAWSAASGGAQDTQYF	MLFSHGLVK	1
CASSPGTVKETQYF	EMLFSHGLVK	1
CASSQEFVGAVLDTQYF	TLREIRRYQK	1
CASSPVYGVAYEQYF	RLLQCTQQAV	1
CASSQDRGIGYGYTF	LLQCTQQAV	1
CASSPRPLEGLYGYTF	YLSHLPLTCKF	1
CASSDLPGAPTDTQYF	ILCETCLIV	1
CASSLAGSKLYEQYF	EHEGSGPEL	1
CASSVERENTGELFF	WSYDSTLLAY	1
CASRKGQGDWEAFF	KAFSPEVIPMF	1
CASSLIAGGGEDTQYF	KAFSPEVIPMF	1
CASGGANYGYTF	KAFSPEVIPMF	1
CASSFWGQGTDTQYF	KAFSPEVIPMF	1
CASSQGVTTGGFLNYGYTF	KAFSPEVIPMF	1
CASTDTGYYGYTF	KAFSPEVIPMF	1
CASSVAGGGQETQYF	VVVGAVGVGK	1
CASSLSFRQGLREQYF	VVVGAVGVGK	1
CASKVYGYTF	GARGVGKSAL	1
CASSLAAGGYFNEQFF	VVVGADGVGK	1
CASSQDVTSEWVDTIYF	AVGVGKSAL	1
CASSQEDNEQFF	AVGVGKSAL	1
CASSLTSGGFDEQFF	VVGAVGVGK	1
CASSPTLYNEQFF	GVYALIAGA	1
CASSLSYLNEQFF	GVYALIAGA	1
CASHPVGSLTDTQYF	GVYALIAGA	1
CASSEWVFWSSYNSPLHF	GVYALIAGA	1
CASSEEPHEKYFF	FIASNGVKLV	1
CASSALGDEQYF	FIASNGVKLV	1
CASSQVEKGRETQYF	FLDEFMEGV	1
CASSLAGGGEQFF	FLDEFMEGV	1
CSVEKGNNYGYTF	RLPGVLPRA	1
CASSLSQGIYYEQYF	RLPGVLPRA	1
CASEGVHEQFF	LLIRWQHFL	1
CASSPVGWGNTIYF	AALPILFQV	1
CASSTMGDYYEQYF	ALLLQLFTL	1
CASSLWAGNTIYF	ALLPGLPAA	1
CAINSGFGSPLHF	ALLPGLPAA	1
CSASQIYEQYF	ALLPGLPAA	1
CASSFSLQYEQYF	ALLPGLPAA	1
CASSLFGLAGVEETQYF	RLPGVLPRA	1
CASSQAISDREVWDQETQYF	RLPGVLPRA	1
CASSLTPPGSYNEQFF	RLPGVLPRA	1
CASSFGGDGYNEQFF	RLPGVLPRA	1
CASSLRDRGNQPQHF	RLPGVLPRA	1
CSVEDLGAGVSNEQFF	RLPGVLPRA	1
CASSYEDHEQYF	RLPGVLPRA	1
CASSYSPGYEQYF	RLPGVLPRA	1
CASSLEVGLAPNEQFF	RLPGVLPRA	1
CASSLAGGSYEQYF	RLPGVLPRA	1
CASSLITGDTEAFF	RLPGVLPRA	1
CASSPRDEQFF	RLGEVRHPV	1
CASSRAGTGYNEQFF	KTFPPTEPK	1
CASSPSVYFEVSGANVLTF	KTFPPTEPK	1
CASSSTGGGGTEAFF	QYDPVAALF	1
CSARFSGQGTEAFF	QYDPVAALF	1
CASSSNQGATQYF	QYDPVAALF	1
CASTPRDRSNYEQYF	QYDPVAALF	1
CAGTGIRSAGELFF	QYDPVAALF	1
CASSSIQGAAGELFF	QYDPVAALF	1
CASSQVSTGETQYF	QYDPVAALF	1
CASRGQVSSQETQYF	QYDPVAALF	1
CASSSTGGGGAEAFF	QYDPVAALF	1
CASDRGGNTGELFF	QYDPVAALF	1
CASSGDRNQPQHF	KLSALGINAV	1
CASSRAVSGNTIYF	KLSALGINAV	1
CASSWDPTYNEQFF	KLSALGINAV	1
CASSFITSGFPYEQYF	KLSALGINAV	1
CATSDSGLAGDYNEQFF	KLSALGINAV	1
CAWSWGDSTNSPLHF	YILEETSVM	1
CASSLARNQPQHF	CVETMCNEY	1
CASGGADMKTEAFF	CVETMCNEY	1
CASSPGGGKETQYF	DEEDAIAAY	1
CASSGEGAKTTNTEAFF	QIKVRVDMV	1
CASSDHSVTGISSPLHF	TPRVTGGGAM	1
CASSYSGQGSAAGETQYF	ELRRKMMYM	1
CASSRLAGGTDTQYF	QIKVRVDMV	1
CASSRLAASTDTQYF	QIKVRVDMV	1
CASSWWDTGELFF	RMFPNAPYL	1
CAWGTLATEQYF	RMFPNAPYL	1
CASSLEIFGGIADTDTQYF	KIFGSLAFL	1
CASSPYRNTEAFF	RPHERNGFTVL	1
CASSKGAAITVGLETQYF	RPHERNGFTVL	1
CSARDLKAGSWVEQYF	RPHERNGFTVL	1
CASSQGLAGGPRTDTQYF	RPHERNGFTVL	1
CAISEGDLNTEAFF	RPHERNGFTVL	1
CASSPQSDQNQGTQYF	RPHERNGFTVL	1
CASSGDPEHGYNYGYTF	RPHERNGFTVL	1
CASSLASDGPQETQYF	RPHERNGFTVL	1
CSGIDKPVTDTQYF	RPHERNGFTVL	1
CSASLASTSNYGYTF	RPHERNGFTVL	1
CASSEGIGYNSPLHF	RPHERNGFTVL	1
CASSWAPNTGELFF	RPHERNGFTVL	1
CSATPARASNTEAFF	RPHERNGFTVL	1
CSARDPQGVTEAFF	RPHERNGFTVL	1
CSARDSSGGAKNIQYF	RPHERNGFTVL	1
CASTFKESIVNTEAFF	GLCTLVAML	1
CSASGYSNQPQHF	GLCTLVAML	1
CASSWAAPGEQFF	GLCTLVAML	1
CASSPGTGGNSPLHF	GLCTLVAML	1
CASSSQGQGHVNTEAFF	GLCTLVAML	1
CASSLKQSGHYQETQYF	GLCTLVAML	1
CASSLASGNSYEQYF	GLCTLVAML	1
CSASHRAGNEQYF	LLWNGPMAV	1
CATGLAGGNEQFF	LLWNGPMAV	1
CATSRGQAYEQYF	LLWNGPMAV	1
CASSFAGTDTQYF	ELAGIGILTV	1
CAWSQMGLGTEAFF	ELAGIGILTV	1
CASSYSFTEATYEQYF	ELAGIGILTV	1
CASSYVGLGSPLHF	ELAGIGILTV	1
CASSWAGPVEQYF	ELAGIGILTV	1
CASSPETGIGGQPQHF	NLSALGIFST	1
CSARQGQGFLYEQYF	NLSALGIFST	1
CASSFEGNTGELFF	NLSALGIFST	1
CASSQVGQAIYGYTF	NLSALGIFST	1
CASSTLRYEQYF	NLSALGIFST	1
CSVEDRGVSYEQYF	NLSALGIFST	1
CASGLDIHAFF	NLSALGIFST	1
CASSPLDNWEQFF	NLSALGIFST	1
CASSLEVTYEQYF	NLSALGIFST	1
CASSLAGEGGNTIYF	NLSALGIFST	1
CASSEGQNYGYTF	NLSALGIFST	1
CATSDRGQGANWDEQFF	NLSALGIFST	1
CASSVATLRVSTNEKLFF	NLSALGIFST	1
CASSIQRNYGYTF	NLSALGIFST	1
CASSATFNDNEKLFF	NLSALGIFST	1
CATSDFGTEAFF	NLSALGIFST	1
CASSGSKGAAGELFF	NLSALGIFST	1
CASSVRTGELFF	QVPLRPMTYK	1
CASSERDSQYQETQYF	QVPLRPMTYK	1
CASSARAFPEGNQPQHF	QVPLRPMTYK	1
CASSYSGQGAAGELFF	QVPLRPMTYK	1
CASSPVLYEQYF	QVPLRPMTYK	1
CASGEVGELFF	QVPLRPMTYK	1
CASRETGWGNQPQHF	QVPLRPMTYK	1
CASSETNRVEMEAFF	QVPLRPMTYK	1
CATSAGRQRDTGELFF	QVPLRPMTYK	1
CASSKYNEQFF	QVPLRPMTYK	1
CSARGAGGFTHYEQYF	QVPLRPMTYK	1
CASSLVGFANTGELFF	QVPLRPMTYK	1
CASSSSGRGLGIQYF	QVPLRPMTYK	1
CASSVSGFSTDTQYF	QVPLRPMTYK	1
CSVLKVGTSGFNEQFF	QVPLRPMTYK	1
CSVPKVGTSGFNEQFF	QVPLRPMTYK	1
CSVPKTGTSGFNEQFF	QVPLRPMTYK	1
CSVVAGGPGDTQYF	QVPLRPMTYK	1
CASSPIKDTRQEYTGELFF	FTSDYYQLY	1
CASSLGTASTDTQYF	PTDNYITTY	1
CASSFSSNSYEQYF	PTDNYITTY	1
CASSAQEGRIEMNTEAFF	ALWEIQQVV	1
CASSSSALEDPEQYF	FLLNKEMYL	1
CASSLEGDVFFF	GLMWLSYFV	1
CASSDGQGGYGYTF	KLWAQCVQL	1
CASSVVDRNNEQFF	LLYDANYFL	1
CATQNLNTGELFF	YLQPRTFLL	1
CASSIVPGSPSRGYTF	NYMPYFFTL	1
CASSPAGGAVLQAFF	QYIKWPWYI	1
CASSPAQGDEQYF	VYAWNRKRI	1
CASSQDRSGGATDTQYF	VYFLQSINF	1
CASSVAGGLYEQFF	VYIGDPAQL	1
CASSADAGTSSEQFF	YYTSNPTTF	1
CASAGTANSPLHF	KPRQKRTAT	1
CASSTGSNTGELFF	RIRGGDGKM	1
CASSSMTSGIRYEQYF	SPRWYFYYL	1
CASSDLAQYLNTGELFF	SPRWYFYYL	1
CASSLAGAQQAFF	SPRWYFYYL	1
CASSLIAGGPEAKNIQYF	SPRWYFYYL	1
CATSDLVEDTQYF	SPRWYFYYL	1
CASSPLTGQGLGGAYEQYF	SPRWYFYYL	1
CASSYLPTGGTDTQYF	SPRWYFYYL	1
CASSLNPNTEAFF	SPRWYFYYL	1
CASSLSGSYEQYF	SPRWYFYYL	1
CASSSSSQEQFF	KRWIILGLNK	1
CASSLEPGTSSYNEQFF	KRWIILGLNK	1
CSARDINPGLAYEQFF	KRWIILGLNK	1
CASSPDSNNEQFF	KRWIILGLNK	1
CASSQGLQGSEQFF	KRWIILGLNK	1
CASSFVDSLSNQPQHF	KRWIILGLNK	1
CASGDRQNSPLHF	KRWIILGLNK	1
CASSLDRNEQFF	KRWIILGLNK	1
CASSLRGLAFTSSYNEQFF	KRWIILGLNK	1
CASSQGQFGNEQFF	KRWIILGLNK	1
CASSHGDYEQYF	KRWIILGLNK	1
CASKKSTGGNTDTQYF	KRWIILGLNK	1
CASSSRQNTEAFF	KRWIILGLNK	1
CASSDRQNTEAFF	KRWIILGLNK	1
CASSHRTGELFF	KRWIILGLNK	1
CASSPGQYSHEQYF	KRWIILGLNK	1
CASSRNNIEAFF	KRWIILGLNK	1
CASREGQGGTEAFF	KRWIIMGLNK	1
CASSLGTSSSYEQYF	KRWIIMGLNK	1
CASSSQENTEAFF	KRWIILGLNK	1
CASSDRQNSPLHF	KRWIILGLNK	1
CASSQGQLNTQYF	KRWIILGLNK	1
CASSLGEQPQHF	KRWIILGLNK	1
CASRGGQGSTEAFF	KRWIIMGLNK	1
CASSPYSGSYEQYF	KRWIILGLNK	1
CASGLGPSGTEAFF	KRWIILGLNK	1
CSARTLEGILTTGETQYF	KRWIILGLNK	1
CASSLGTSAYEQYF	KRWIILGLNK	1
CTRAYNQPQHF	KRWIILGLNK	1
CASTIPPGTSVSGELFF	KRWIILGLNK	1
CASGSGLANNEQFF	KRWIILGLNK	1
CASSRADLSYEQYF	KRWIILGLNK	1
CASSQRTGELFF	KRWIILGLNK	1
CASSFDSYEQYF	KRWIILGLNK	1
CASSPRSLSYEQYF	KRWIILGLNK	1
CASSGNTGELFF	KRWIILGLNK	1
CASSYRTGELFF	KRWIILGLNK	1
CASSQGLAGREQYF	KRWIILGLNK	1
CATSDVNGAYEQYF	KRWIILGLNK	1
CSARGGSVFYEQYF	KRWIIMGLNK	1
CSARGGERFYEQYF	KRWIIMGLNK	1
CASSASTSDYSYEQYF	KRWIIMGLNK	1
CASSDLTGTAYNEQFF	KRWIIMGLNK	1
CSVTWDRNTGELFF	YLQPRTFLL	1
CASSDLNTGELFF	YLQPRTFLL	1
CSARGLAEANTGELFF	YLQPRTFLL	1
CSARDPSGVKLFF	YLQPRTFLL	1
CASSYPTGEGQETQYF	YLQPRTFLL	1
CASSPTGGGNTGELFF	YLQPRTFLL	1
CASSAGVSGEQYF	YLQPRTFLL	1
CASSFARAQADTQYF	YLQPRTFLL	1
CASRDGRESYEQYF	YLQPRTFLL	1
CASSIGDEQYF	YLQPRTFLL	1
CASQDTNTGELFF	YLQPRTFLL	1
CASSDRGRSYEQYF	YLQPRTFLL	1
CASSQVESADTQYF	YLQPRTFLL	1
CASSPDIDQFF	YLQPRTFLL	1
CASSLAGPNEQFF	YLQPRTFLL	1
CASNNANTGELFF	YLQPRTFLL	1
CSARWGLLVNTGELFF	YLQPRTFLL	1
CASSLDIEQYF	YLQPRTFLL	1
CASSVEPGWDEQYF	YLQPRTFLL	1
CATTEGVAGELFF	YLQPRTFLL	1
CASRQLAGFYEQYF	SPRWYFYYL	1
CASSVSGGAYNEQFF	SPRWYFYYL	1
CSARGGFRSGGGTDEQFF	SPRWYFYYL	1
CSVDALLGAYTQYF	SPRWYFYYL	1
CSATDRAASYNSPLHF	SPRWYFYYL	1
CASRGGGTEAFF	SPRWYFYYL	1
CASSTLGTADKLNYGYTF	SPRWYFYYL	1
CASSSLTGQSQETQYF	SPRWYFYYL	1
CASSLETGRNIQYF	SPRWYFYYL	1
CSVVPLMGGYEQYF	SPRWYFYYL	1
CASSSKPGGDYNEQFF	SPRWYFYYL	1
CASNPLAGEFTAKNIQYF	SPRWYFYYL	1
CSVVPLAGPYEQYF	SPRWYFYYL	1
CASSETGGYEQYF	NYNYLYRLF	1
CASSESQGYEQYF	NYNYLYRLF	1
CASSEGQGYEQFF	NYNYLYRLF	1
CASSEGQGYEQYF	NYNYLYRLF	1
CASSLASGYEQYF	NYNYLYRLF	1
CASSEFRSYEQYF	NYNYLYRLF	1
CASSERTGYEQYF	NYNYLYRLF	1
CASSLLGGYEQYF	NYNYLYRLF	1
CAWSVTGVTEAFF	NYNYLYRLF	1
CASSRGSGVSYEQYF	NYNYLYRLF	1
CASASGQGYEQYF	NYNYLYRLF	1
CASSQGPGPYEQYF	NYNYLYRLF	1
CASSEWGQGVAYGYTF	NYNYLYRLF	1
CASSQSGGGEQFF	QYIKWPWYI	1
CASCPSWGSGANVLTF	QYIKWPWYI	1
CASSVGATGAYEQYF	QYIKWPWYI	1
CASSFHPGQDRGNSPLHF	QYIKWPWYI	1
CASSLVGEGRGREQYF	QYIKWPWYI	1
CSARDQDRAYEQYF	QYIKWPWYI	1
CASSLSTTTASYEQYF	QYIKWPWYI	1
CASTPWGAEAFF	QYIKWPWYI	1
CSVDPGQFYNEQFF	QYIKWPWYI	1
CASSLGETIYGYTF	QYIKWPWYI	1
CSARTISQGAHYEQYF	QYIKWPWYI	1
CAGKSTGELFF	QYIKWPWYI	1
CASSWNGLAGDEQFF	QYIKWPWYI	1
CASSALVAFSTDTQYF	QYIKWPWYI	1
CASSSLAGEVNEQFF	QYIKWPWYI	1
CASSSYTQRGLDYTGELFF	QYIKWPWYI	1
CSVEDPMGVGTEAFF	QYIKWPWYI	1
CASSQDYWGGGADTQYF	QYIKWPWYI	1
